Rank,Release Group,Worldwide,Domestic,Domestic %,Foreign,Foreign %,Year
1,Avengers: Endgame,2797501328,858373000,0.30683560054417247,1939128328,0.6931643994558275,2019
2,Avatar,2743577587,749766139,0.27328045780540194,1993811448,0.726719542194598,2009
3,Star Wars: Episode VII - The Force Awakens,2068223624,936662225,0.4528824707980417,1131561399,0.5471175292019583,2015
4,Avengers: Infinity War,2048359754,678815482,0.3313946589091205,1369544272,0.6686053410908794,2018
5,Jurassic World,1670400637,652270625,0.39048753368022093,1018130012,0.6095124663197791,2015
6,The Lion King,1656943394,543638043,0.32809693135479556,1113305351,0.6719030686452044,2019
7,The Avengers,1518812988,623357910,0.41042440045291473,895455078,0.5895755995470853,2012
8,Furious 7,1515047671,353007020,0.23300060239490641,1162040651,0.7669993976050936,2015
9,Frozen II,1450026933,477373578,0.329217042205105,972653355,0.6707829577948949,2019
10,Avengers: Age of Ultron,1402805868,459005868,0.3272055517235689,943800000,0.6727944482764311,2015
11,Black Panther,1346913161,700059566,0.5197510769589992,646853595,0.4802489230410007,2018
12,Harry Potter and the Deathly Hallows: Part 2,1341511219,381011219,0.2840164238686102,960500000,0.7159835761313897,2011
13,Star Wars: Episode VIII - The Last Jedi,1332539889,620181382,0.465412995978239,712358507,0.5345870040217611,2017
14,Jurassic World: Fallen Kingdom,1308467944,417719760,0.3192434036427567,890748184,0.6807565963572433,2018
15,Frozen,1280802282,400738009,0.31288046143565507,880064273,0.6871195385643449,2013
16,Beauty and the Beast,1263521126,504014165,0.3988965080430321,759506961,0.6011034919569679,2017
17,Incredibles 2,1242805359,608581744,0.48968387494698595,634223615,0.510316125053014,2018
18,The Fate of the Furious,1236005118,226008385,0.1828539232634472,1009996733,0.8171460767365528,2017
19,Iron Man 3,1214811252,409013994,0.33668933616363966,805797258,0.6633106638363603,2013
20,Minions,1159398397,336045770,0.28984494964762314,823352627,0.7101550503523768,2015
21,Captain America: Civil War,1153296293,408084349,0.35384172434862754,745211944,0.6461582756513724,2016
22,Aquaman,1148461807,335061807,0.2917483236776023,813400000,0.7082516763223977,2018
23,The Lord of the Rings: The Return of the King,1140682011,377027325,0.3305279835784138,763654686,0.6694720164215863,2003
24,Spider-Man: Far from Home,1131927996,390532085,0.345014953583673,741395911,0.654985046416327,2019
25,Captain Marvel,1128274794,426829839,0.3783030882811692,701444955,0.6216969117188308,2019
26,Transformers: Dark of the Moon,1123794079,352390543,0.3135721655639725,771403536,0.6864278344360275,2011
27,Skyfall,1108561013,304360277,0.2745543758356943,804200736,0.7254456241643057,2012
28,Transformers: Age of Extinction,1104054072,245439076,0.22230711540729683,858614996,0.7776928845927031,2014
29,The Dark Knight Rises,1081041287,448139099,0.4145439257399981,632902188,0.5854560742600019,2012
30,Joker,1074251311,335451311,0.3122652097931673,738800000,0.6877347902068327,2019
31,Star Wars: Episode IX - The Rise of Skywalker,1074144248,515202542,0.4796399952420543,558941706,0.5203600047579457,2019
32,Toy Story 4,1073394593,434038008,0.4043601587249657,639356585,0.5956398412750342,2019
33,Toy Story 3,1066969703,415004880,0.3889565737744289,651964823,0.6110434262255711,2010
34,Pirates of the Caribbean: Dead Man's Chest,1066179725,423315812,0.3970398255322291,642863913,0.602960174467771,2006
35,Rogue One: A Star Wars Story,1056057273,532177324,0.5039284682810948,523879949,0.49607153171890517,2016
36,Aladdin,1050693953,355559216,0.3384041708670612,695134737,0.6615958291329388,2019
37,Pirates of the Caribbean: On Stranger Tides,1045713802,241071802,0.23053325062644625,804642000,0.7694667493735537,2011
38,Despicable Me 3,1034799409,264624300,0.2557252136969475,770175109,0.7442747863030524,2017
39,Finding Dory,1028570889,486295561,0.47278759898871686,542275328,0.5272124010112832,2016
40,Alice in Wonderland,1025467110,334191110,0.32589159295416115,691276000,0.6741084070458389,2010
41,Zootopia,1023784195,341268248,0.3333400238709487,682515947,0.6666599761290513,2016
42,The Hobbit: An Unexpected Journey,1017003568,303003568,0.29793756633113405,714000000,0.7020624336688659,2012
43,The Dark Knight,1003045358,533345358,0.5317260617839378,469700000,0.4682739382160622,2008
44,Harry Potter and the Deathly Hallows: Part 1,976536918,295983305,0.30309484418283916,680553613,0.6969051558171608,2010
45,Harry Potter and the Sorcerer's Stone,974755371,317575550,0.32580025660612644,657179821,0.6741997433938736,2001
46,Despicable Me 2,970766005,368065385,0.3791494377679614,602700620,0.6208505622320386,2013
47,The Jungle Book,966550600,364001123,0.3765981036067848,602549477,0.6234018963932152,2016
48,Jumanji: Welcome to the Jungle,962077546,404515480,0.42046036900231326,557562066,0.5795396309976868,2017
49,Pirates of the Caribbean: At World's End,960996492,309420425,0.32197872476729084,651576067,0.6780212752327092,2007
50,The Hobbit: The Desolation of Smaug,958366855,258366855,0.2695907664711547,700000000,0.7304092335288452,2013
51,The Hobbit: The Battle of the Five Armies,956019788,255119788,0.26685617934092387,700900000,0.7331438206590761,2014
52,Harry Potter and the Order of the Phoenix,941676843,292004738,0.31009017602018274,649672105,0.6899098239798173,2007
53,The Lord of the Rings: The Two Towers,936689735,339789881,0.36275606351125433,596899854,0.6372439364887457,2002
54,Harry Potter and the Half-Blood Prince,933959197,301959197,0.32331090905248616,632000000,0.6766890909475138,2009
55,Shrek 2,928760770,441226247,0.47506985787093486,487534523,0.5249301421290652,2004
56,Bohemian Rhapsody,903655259,216428042,0.23950288546929155,687227217,0.7604971145307085,2018
57,Harry Potter and the Goblet of Fire,895921036,290013036,0.3237037912345659,605908000,0.6762962087654341,2005
58,Spider-Man 3,894983373,336530303,0.3760184972732449,558453070,0.6239815027267551,2007
59,Ice Age: Dawn of the Dinosaurs,886686817,196573705,0.22169462907442775,690113112,0.7783053709255723,2009
60,The Lord of the Rings: The Fellowship of the Ring,880839846,313364114,0.35575606101724877,567475732,0.6442439389827512,2001
61,Spectre,880674609,200074609,0.22718335121207064,680600000,0.7728166487879293,2015
62,Spider-Man: Homecoming,880166924,334201140,0.37970199843592395,545965784,0.620298001564076,2017
63,Harry Potter and the Chamber of Secrets,878979634,261988482,0.2980597864455185,616991152,0.7019402135544816,2002
64,Ice Age: Continental Drift,877244782,161321843,0.18389604168657225,715922939,0.8161039583134277,2012
65,The Secret Life of Pets,875457937,368384330,0.42079043941548044,507073607,0.5792095605845196,2016
66,Batman v Superman: Dawn of Justice,873634919,330360194,0.3781444477724682,543274725,0.6218555522275317,2016
67,Finding Nemo,871014978,339714978,0.3900219704373442,531300000,0.6099780295626558,2003
68,Wolf Warrior 2,870325439,2721100,0.003126531614572282,867604339,0.9968734683854277,2017
69,Star Wars: Episode III - Revenge of the Sith,868352530,380270577,0.437921885250913,488081953,0.562078114749087,2005
70,The Hunger Games: Catching Fire,865011746,424668047,0.490939052520103,440343699,0.5090609474798969,2013
71,Guardians of the Galaxy Vol. 2,863756051,389813101,0.4512999944240043,473942950,0.5487000055759956,2017
72,Inside Out,857611174,356461711,0.4156449004009829,501149463,0.5843550995990171,2015
73,Venom,856085151,213515506,0.24940919224050412,642569645,0.7505908077594958,2018
74,Thor: Ragnarok,853977126,315058289,0.36893059475225337,538918837,0.6310694052477467,2017
75,Transformers: Revenge of the Fallen,836303693,402111870,0.4808203925986968,434191823,0.5191796074013032,2009
76,The Twilight Saga: Breaking Dawn - Part 2,829746820,292324737,0.35230594436023266,537422083,0.6476940556397673,2012
77,Inception,826137188,292576195,0.3541496488111125,533560993,0.6458503511888876,2010
78,"Hi, Mom",822009764,0,0.0,822009764,1.0,2021
79,Wonder Woman,821847012,412563408,0.501995385973369,409283604,0.49800461402663104,2017
80,Spider-Man,821708551,403706375,0.4913011730359856,418002176,0.5086988269640144,2002
81,Fantastic Beasts and Where to Find Them,814037575,234037575,0.287502177034027,580000000,0.7124978229659731,2016
82,Shrek the Third,813367380,322719944,0.3967702073323865,490647436,0.6032297926676135,2007
83,Coco,807816196,210460015,0.2605295809147159,597356181,0.7394704190852841,2017
84,Jumanji: The Next Level,800059707,320314960,0.4003638193467978,479744747,0.5996361806532021,2019
85,Harry Potter and the Prisoner of Azkaban,795634069,249541069,0.31363798852107727,546093000,0.6863620114789227,2004
86,Pirates of the Caribbean: Dead Men Tell No Tales,794861794,172558876,0.21709293024593404,622302918,0.782907069754066,2017
87,Mission: Impossible - Fallout,791115104,220159104,0.27828959766643513,570956000,0.7217104023335649,2018
88,Indiana Jones and the Kingdom of the Crystal Skull,790653942,317101119,0.40106183268735285,473552823,0.5989381673126472,2008
89,Fast & Furious 6,788679850,238679850,0.30263211365169274,550000000,0.6973678863483073,2013
90,Spider-Man 2,788618317,373585825,0.4737219729072055,415032492,0.5262780270927945,2004
91,Deadpool,782612155,363070709,0.463921633059737,419541446,0.536078366940263,2016
92,Guardians of the Galaxy,772776600,333176600,0.4311421955581988,439600000,0.5688578044418011,2014
93,2012,769679473,166112167,0.21581992612137652,603567306,0.7841800738786235,2009
94,The Da Vinci Code,760006945,217536138,0.28622914491919543,542470807,0.7137708550808045,2006
95,Fast & Furious Presents: Hobbs & Shaw,759056935,173956935,0.22917508157671992,585100000,0.77082491842328,2019
96,Maleficent,758410378,241410378,0.31831101604466705,517000000,0.681688983955333,2014
97,The Amazing Spider-Man,757930663,262030663,0.34571851462354675,495900000,0.6542814853764533,2012
98,The Hunger Games: Mockingjay - Part 1,755356711,337135885,0.44632672231596815,418220826,0.5536732776840319,2014
99,Shrek Forever After,752600867,238736787,0.31721566831519477,513864080,0.6827843316848052,2010
100,Madagascar 3: Europe's Most Wanted,746921274,216391482,0.2897112313338661,530529792,0.7102887686661339,2012
101,Suicide Squad,746846894,325100054,0.43529678788488074,421746840,0.5647032121151193,2016
102,X-Men: Days of Future Past,746045700,233921534,0.3135485319465014,512124166,0.6864514680534985,2014
103,"The Chronicles of Narnia: The Lion, the Witch and the Wardrobe",745013115,291710957,0.39155143866158654,453302158,0.6084485613384135,2005
104,Monsters University,743559607,268492764,0.3610911102114238,475066843,0.6389088897885762,2013
105,The Matrix Reloaded,739412035,281576461,0.3808113036731949,457835574,0.6191886963268052,2003
106,Up,735099082,293004164,0.3985913888000203,442094918,0.6014086111999797,2009
107,Deadpool 2,734546611,318491426,0.43358912998919275,416055185,0.5664108700108073,2018
108,Ne Zha,726063471,3695533,0.005089820859476899,722367938,0.9949101791405232,2019
109,Gravity,723192705,274092705,0.37900369169238235,449100000,0.6209963083076177,2013
110,F9: The Fast Saga,716591945,173005945,0.2414288162281813,543586000,0.7585711837718186,2021
111,Captain America: The Winter Soldier,714421503,259766572,0.3636040781376089,454654931,0.6363959218623911,2014
112,The Twilight Saga: Breaking Dawn - Part 1,712205856,281287133,0.394952008089077,430918723,0.6050479919109231,2011
113,Dawn of the Planet of the Apes,710644566,208545589,0.29345976734028806,502098977,0.7065402326597119,2014
114,The Twilight Saga: New Moon,709827462,296623634,0.4178813160655089,413203828,0.5821186839344911,2009
115,Transformers,709709780,319246193,0.44982639664342794,390463587,0.5501736033565721,2007
116,The Amazing Spider-Man 2,708982323,202853933,0.28611987410580336,506128390,0.7138801258941967,2014
117,It,700381748,327481748,0.4675760739555994,372900000,0.5324239260444006,2017
118,The Wandering Earth,699856699,5971413,0.008532336703402763,693885286,0.9914676632965972,2019
119,The Twilight Saga: Eclipse,698491347,300531751,0.4302583736946422,397959596,0.5697416263053579,2010
120,Mission: Impossible - Ghost Protocol,694713380,209397903,0.3014162516921727,485315477,0.6985837483078273,2011
121,The Hunger Games,694394724,408010692,0.5875774655223331,286384032,0.4124225344776669,2012
122,Detective Chinatown 3,686257563,0,0.0,686257563,1.0,2021
123,Mission: Impossible - Rogue Nation,682714267,195042377,0.2856866868434727,487671890,0.7143133131565274,2015
124,Interstellar,677896797,188020017,0.2773578778245798,489876780,0.7226421221754201,2014
125,Doctor Strange,677718395,232641920,0.3432722524817996,445076475,0.6567277475182004,2016
126,Man of Steel,668045518,291045518,0.4356671965577052,377000000,0.5643328034422948,2013
127,Kung Fu Panda 2,665692281,165249063,0.24823641150196843,500443218,0.7517635884980316,2011
128,Ice Age: The Meltdown,660998756,195330621,0.29550830349822926,465668135,0.7044916965017707,2006
129,The Hunger Games: Mockingjay - Part 2,658344137,281723902,0.4279280184430351,376620235,0.5720719815569649,2015
130,Justice League,657924295,229024295,0.3481012887660578,428900000,0.6518987112339422,2017
131,Big Hero 6,657827828,222527828,0.33827670178769026,435300000,0.6617232982123098,2014
132,Fantastic Beasts: The Crimes of Grindelwald,654855901,159555901,0.24365039813545178,495300000,0.7563496018645482,2018
133,Pirates of the Caribbean: The Curse of the Black Pearl,654264015,305413918,0.4668053125312111,348850097,0.5331946874687888,2003
134,Star Wars: Episode II - Attack of the Clones,645256452,302191252,0.4683273620331037,343065200,0.5316726379668963,2002
135,Thor: The Dark World,644783140,206362140,0.32004890822672566,438421000,0.6799510917732744,2013
136,Moana,643331111,248757044,0.38667031602642327,394574067,0.6133296839735767,2016
137,Sing,634151679,270395425,0.42638919670825315,363756254,0.5736108032917469,2016
138,Kung Fu Panda,631744560,215434591,0.3410153480387706,416309969,0.6589846519612294,2008
139,The Incredibles,631442092,261441092,0.4140381126192012,370001000,0.5859618873807988,2004
140,The Martian,630161890,228433663,0.36249996488997455,401728227,0.6375000351100255,2015
141,Hancock,629443428,227946274,0.3621394137425167,401497154,0.6378605862574833,2008
142,Fast Five,626137675,209837675,0.33513024911014977,416300000,0.6648697508898502,2011
143,Men in Black 3,624026776,179020854,0.2868800841328001,445005922,0.7131199158671999,2012
144,Iron Man 2,623933331,312433331,0.5007479412892594,311500000,0.4992520587107407,2010
145,Ratatouille,623726085,206445654,0.3309876866862158,417280431,0.6690123133137842,2007
146,Ant-Man and the Wasp,622674139,216648740,0.3479327732285988,406025399,0.6520672267714012,2018
147,How to Train Your Dragon 2,621537519,177002924,0.2847823640393944,444534595,0.7152176359606056,2014
148,Logan,619021436,226277068,0.36553995522701094,392744368,0.6344600447729891,2017
149,The Passion of the Christ,611486736,370274604,0.6055317019991747,241212132,0.39446829800082533,2004
150,Mamma Mia!,609841637,144130063,0.23634014841790804,465711574,0.7636598515820919,2008
151,Life of Pi,609016565,124987023,0.20522762463776334,484029542,0.7947723753622367,2012
152,Casino Royale,605999592,167445960,0.27631365137948805,438553632,0.723686348620512,2006
153,Transformers: The Last Knight,605425157,130168683,0.21500375644284633,475256474,0.7849962435571537,2017
154,Madagascar: Escape 2 Africa,603900354,180010950,0.298080550553875,423889404,0.701919449446125,2008
155,War of the Worlds,603873119,234280354,0.38796287933459084,369592765,0.6120371206654092,2005
156,Tangled,592461732,200821936,0.33896186901738995,391639796,0.66103813098261,2010
157,Quantum of Solace,589580482,168368427,0.2855732714028345,421212055,0.7144267285971655,2008
158,The Croods,587204668,187168425,0.3187447838885368,400036243,0.6812552161114632,2013
159,The Hangover Part II,586764305,254464305,0.43367379854505633,332300000,0.5663262014549436,2011
160,I Am Legend,585410052,256393010,0.4379716561477834,329017042,0.5620283438522166,2007
161,Iron Man,585366247,318604126,0.5442816828487209,266762121,0.45571831715127914,2008
162,Ready Player One,582890172,137690172,0.23621975221774713,445200000,0.7637802477822528,2018
163,Operation Red Sea,579330426,1543547,0.0026643637736368433,577786879,0.9973356362263631,2018
164,Night at the Museum,574480841,250863268,0.43667821465259277,323617573,0.5633217853474073,2006
165,Fifty Shades of Grey,569651467,166167230,0.2916998193212763,403484237,0.7083001806787237,2015
166,Kong: Skull Island,566652812,168052812,0.29657103686975084,398600000,0.7034289631302492,2017
167,The Smurfs,563749323,142614158,0.2529744199799243,421135165,0.7470255800200757,2011
168,Cars 2,559852396,191452396,0.3419694143811434,368400000,0.6580305856188566,2011
169,King Kong,556906378,218080025,0.3915918969776999,338826353,0.6084081030223001,2005
170,Puss in Boots,554987477,149260504,0.26894391348581725,405726973,0.7310560865141827,2011
171,The Mermaid,553810228,3232685,0.005837170995693492,550577543,0.9941628290043065,2016
172,The Day After Tomorrow,552639571,186740799,0.3379070352528194,365898772,0.6620929647471806,2004
173,Ted,549368315,218815487,0.398303799155217,330552828,0.6016962008447829,2012
174,American Sniper,547426372,350126372,0.639586234621521,197300000,0.3604137653784791,2014
175,Mission: Impossible II,546388108,215409889,0.3942433699527004,330978219,0.6057566300472996,2000
176,Detective Chinatown 2,544185156,1983984,0.0036457885301083076,542201172,0.9963542114698917,2018
177,X-Men: Apocalypse,543934105,155442489,0.285774485495812,388491616,0.7142255145041879,2016
178,Sherlock Holmes: A Game of Shadows,543848418,186848418,0.3435670893134785,357000000,0.6564329106865214,2011
179,Despicable Me,543113985,251513985,0.4630961307321151,291600000,0.5369038692678849,2010
180,Cinderella,542351353,201151353,0.3708875286976559,341200000,0.6291124713023442,2015
181,Madagascar,542063846,193595521,0.35714523746341126,348468325,0.6428547625365887,2005
182,World War Z,540007876,202359711,0.37473473997997764,337648165,0.6252652600200224,2013
183,Brave,538983207,237283207,0.4402423005360907,301700000,0.5597576994639093,2012
184,The Simpsons Movie,536414270,183135014,0.34140593239624295,353279256,0.658594067603757,2007
185,The Revenant,532950503,183637894,0.34456838480552104,349312609,0.6554316151944789,2015
186,The Meg,530243742,145443742,0.2742960085703378,384800000,0.7257039914296621,2018
187,Ralph Breaks the Internet,529323962,201091711,0.3799029052835511,328232251,0.6200970947164489,2018
188,"Monsters, Inc.",528773250,255873250,0.48389976232723575,272900000,0.5161002376727643,2001
189,Hotel Transylvania 3: Summer Vacation,528583774,167510016,0.31690343941583043,361073758,0.6830965605841696,2018
190,The Boss Baby,527965936,175003033,0.331466522870521,352962903,0.6685334771294791,2017
191,Dunkirk,525245546,188045546,0.3580145465907482,337200000,0.6419854534092517,2017
192,Godzilla,524976069,200676069,0.38225755582013016,324300000,0.6177424441798699,2014
193,Sherlock Holmes,524028679,209028679,0.39888786125005193,315000000,0.6011121387499481,2009
194,Meet the Fockers,522657936,279261160,0.5343096139269183,243396776,0.46569038607308166,2004
195,How to Train Your Dragon: The Hidden World,521799505,160799505,0.3081633912243746,361000000,0.6918366087756255,2019
196,WALL·E,521311860,223808164,0.4293172305728859,297503696,0.5706827694271142,2008
197,Kung Fu Panda 3,521170825,143528619,0.2753964959569638,377642206,0.7246035040430362,2016
198,Ant-Man,519311965,180202163,0.3470017545234106,339109802,0.6529982454765894,2015
199,The Grinch,511595957,270620950,0.5289739809261237,240975007,0.4710260190738763,2018
200,Rio 2,498781117,131538435,0.2637197570572825,367242682,0.7362802429427175,2014
201,Troy,497409852,133378256,0.268145585504004,364031596,0.731854414495996,2004
202,How to Train Your Dragon,494878759,217581231,0.4396657303289107,277297528,0.5603342696710892,2010
203,Oz the Great and Powerful,493311825,234911825,0.47619337930932426,258400000,0.5238066206906757,2013
204,Clash of the Titans,493214993,163214888,0.33092037005452507,330000105,0.6690796299454749,2010
205,Maleficent: Mistress of Evil,491730089,113929605,0.23169134358178353,377800484,0.7683086564182164,2019
206,War for the Planet of the Apes,490719763,146880162,0.2993157665019495,343839601,0.7006842334980505,2017
207,Mr. & Mrs. Smith,487287646,186336279,0.38239483502112015,300951367,0.6176051649788799,2005
208,Angels & Demons,485930816,133375846,0.2744749697043293,352554970,0.7255250302956707,2009
209,Teenage Mutant Ninja Turtles,485004754,191204754,0.39423274189184543,293800000,0.6057672581081546,2014
210,Bruce Almighty,484592874,242829261,0.5010995291688916,241763613,0.49890047083110844,2003
211,Shrek,484409218,267665011,0.5525596975737155,216744207,0.4474403024262845,2001
212,Rio,483866518,143619809,0.29681700150205476,340246709,0.7031829984979453,2011
213,Rise of the Planet of the Apes,481800873,176760185,0.3668739408863628,305040688,0.6331260591136372,2011
214,Charlie and the Chocolate Factory,474968763,206459076,0.43467927173981336,268509687,0.5653207282601866,2005
215,Hotel Transylvania 2,474800000,169700110,0.3574138795282224,305099890,0.6425861204717775,2015
216,San Andreas,473990832,155190832,0.32741315131597315,318800000,0.6725868486840269,2015
217,It Chapter Two,473093228,211593228,0.44725482310222375,261500000,0.5527451768977762,2019
218,Wreck-It Ralph,471222889,189422889,0.40198151113156133,281800000,0.5980184888684387,2012
219,The Hangover,468812793,277322503,0.5915420977003928,191490290,0.40845790229960727,2009
220,The Lego Movie,468060692,257760692,0.5506992926464331,210300000,0.44930070735356686,2014
221,Bumblebee,467989645,127195589,0.2717914602576303,340794056,0.7282085397423698,2018
222,Godzilla vs. Kong,467863133,100563133,0.21494134909749343,367300000,0.7850586509025066,2021
223,Star Trek Into Darkness,467365246,228778661,0.4895072172311246,238586585,0.5104927827688753,2013
224,Cars,461983149,244082982,0.5283374134496841,217900167,0.47166258655031595,2006
225,The Eight Hundred,461421559,372755,0.0008078404502985089,461048804,0.9991921595497015,2020
226,Gladiator,460583960,187705427,0.4075379155626696,272878533,0.5924620844373304,2000
227,X-Men: The Last Stand,460435291,234362462,0.5090019522417538,226072829,0.49099804775824624,2006
228,National Treasure: Book of Secrets,459242249,219964115,0.47897186175481865,239278134,0.5210281382451813,2007
229,Lucy,458863600,126663600,0.27603758502526676,332200000,0.7239624149747332,2014
230,300,456068181,210614939,0.4618058171438187,245453242,0.5381941828561814,2007
231,The Last Samurai,454627263,111127263,0.24443598535356645,343500000,0.7555640146464335,2003
232,Demon Slayer: Mugen Train,452974619,47700000,0.10530391328614375,405274619,0.8946960867138563,2020
233,Dying to Survive,451176639,0,0.0,451176639,1.0,2018
234,Ocean's Eleven,450717150,183417150,0.4069451317749946,267300000,0.5930548682250054,2001
235,"My People, My Country",450064993,2356683,0.005236317057878794,447708310,0.9947636829421213,2019
236,Thor,449326618,181030624,0.40289316668081304,268295994,0.597106833319187,2011
237,Pearl Harbor,449220945,198542554,0.44197083018914,250678391,0.55802916981086,2001
238,La La Land,447407695,151101803,0.3377273227274287,296305892,0.6622726772725712,2016
239,The Bourne Ultimatum,444100035,227471070,0.5122068274549899,216628965,0.48779317254501003,2007
240,Alvin and the Chipmunks: The Squeakquel,443140005,219614612,0.4955874205038202,223525393,0.5044125794961798,2009
241,Men in Black II,441818803,190418803,0.43098845433248795,251400000,0.569011545667512,2002
242,Les Misérables,441809770,148809770,0.33681864934765926,293000000,0.6631813506523407,2012
243,Terminator Genisys,440603537,89760956,0.20372273134974855,350842581,0.7962772686502514,2015
244,Warcraft,439048914,47365290,0.10788157877097038,391683624,0.8921184212290296,2016
245,A Star Is Born,436188866,215288866,0.4935679995096436,220900000,0.5064320004903564,2018
246,The Greatest Showman,434993183,174340174,0.4007882900546513,260653009,0.5992117099453488,2017
247,Terminator 3: Rise of the Machines,433371112,150371112,0.34698000821060726,283000000,0.6530199917893927,2003
248,The Mummy Returns,433013274,202019785,0.46654409259518453,230993489,0.5334559074048155,2001
249,Pokémon Detective Pikachu,433005346,144105346,0.3328026947731957,288900000,0.6671973052268043,2019
250,Die Another Day,431971116,160942139,0.37257615854111875,271028977,0.6274238414588812,2002
251,The Secret Life of Pets 2,430051293,158874395,0.36943126921374003,271176898,0.63056873078626,2019
252,Cast Away,429632142,233632142,0.5437957712204875,196000000,0.4562042287795125,2000
253,Rampage,428028233,101028233,0.2360317035441912,327000000,0.7639682964558088,2018
254,The Matrix Revolutions,427343298,139313948,0.32600007687496246,288029350,0.6739999231250375,2003
255,The Intouchables,426588510,10198820,0.023907863810021513,416389690,0.9760921361899785,2011
256,Bad Boys for Life,426505244,206305244,0.4837109200936343,220200000,0.5162890799063657,2020
257,Django Unchained,425368238,162805434,0.38273998727662406,262562804,0.6172600127233759,2012
258,The King's Speech,423999102,135453143,0.3194656365097679,288545959,0.6805343634902321,2010
259,"My People, My Homeland",422390820,0,0.0,422390820,1.0,2020
260,The Chronicles of Narnia: Prince Caspian,419665568,141621490,0.33746273413595845,278044078,0.6625372658640415,2008
261,Sex and the City,418765321,152647258,0.3645174286053166,266118063,0.6354825713946833,2008
262,The Captain,417282021,706572,0.0016932720904359309,416575449,0.9983067279095641,2019
263,The Chronicles of Narnia: The Voyage of the Dawn Treader,415686217,104386950,0.25111958427045944,311299267,0.7488804157295406,2010
264,Jason Bourne,415484914,162434410,0.39095140287091146,253050504,0.6090485971290885,2016
265,The Wolverine,414828246,132556852,0.3195463502743253,282271394,0.6804536497256747,2013
266,Kingsman: The Secret Service,414351546,128261724,0.3095480763573644,286089822,0.6904519236426355,2015
267,Night at the Museum: Battle of the Smithsonian,413106170,177243721,0.4290512557582957,235862449,0.5709487442417043,2009
268,Pacific Rim,411002906,101802906,0.24769388370212642,309200000,0.7523061162978736,2013
269,Kingsman: The Golden Circle,410902662,100234838,0.24393815681826855,310667824,0.7560618431817314,2017
270,The Mummy,409231607,80227895,0.196045206742792,329003712,0.803954793257208,2017
271,Ice Age: Collision Course,408579038,64063008,0.15679465180981703,344516030,0.843205348190183,2016
272,Signs,408247917,227966634,0.5584024425040728,180281283,0.44159755749592716,2002
273,X2: X-Men United,407711549,214949694,0.5272102164562427,192761855,0.4727897835437573,2003
274,Twilight,407187715,192769854,0.47341765701354716,214417861,0.5265823429864528,2008
275,The Battle at Lake Changjin,405000000,0,0.0,405000000,1.0,2021
276,Alita: Battle Angel,404980543,85838210,0.21195638033405473,319142333,0.7880436196659453,2019
277,The Mummy: Tomb of the Dragon Emperor,403449830,102491776,0.2540384661954127,300958054,0.7459615338045873,2008
278,Prometheus,403354469,126477084,0.3135631156227502,276877385,0.6864368843772498,2012
279,Shang-Chi and the Legend of the Ten Rings,401556765,212456765,0.529082768659121,189100000,0.47091723134087904,2021
280,TRON: Legacy,400062763,172062763,0.4300894232438224,228000000,0.5699105767561776,2010
281,Mission: Impossible III,398479497,134029801,0.33635306711903423,264449696,0.6636469328809658,2006
282,Snow White and the Huntsman,396592829,155332381,0.39166714484391246,241260448,0.6083328551560876,2012
283,Mamma Mia! Here We Go Again,395044706,120634935,0.3053703369967449,274409771,0.6946296630032551,2018
284,Solo: A Star Wars Story,392924807,213767512,0.5440417815106289,179157295,0.4559582184893712,2018
285,The Wolf of Wall Street,392000694,116900694,0.2982155281592435,275100000,0.7017844718407565,2013
286,Superman Returns,391081192,200081192,0.5116103665757468,191000000,0.48838963342425323,2006
287,Independence Day: Resurgence,389681935,103144286,0.26468839516514925,286537649,0.7353116048348508,2016
288,Live Free or Die Hard,388156011,134529403,0.34658590666524547,253626608,0.6534140933347545,2007
289,Monster Hunt,387053506,32766,8.465496240718718e-05,387020740,0.9999153450375928,2015
290,Godzilla: King of the Monsters,386600138,110500138,0.2858253971963145,276100000,0.7141746028036855,2019
291,Home,386041607,177397510,0.45952950869360565,208644097,0.5404704913063944,2015
292,Star Trek,385680446,257730019,0.6682475652395403,127950427,0.3317524347604597,2009
293,1917,384983987,159227644,0.4135954984538097,225756343,0.5864045015461903,2019
294,Happy Feet,384335608,198000317,0.515175572803028,186335291,0.48482442719697205,2006
295,Cars 3,383930656,152901115,0.3982519046356121,231029541,0.6017480953643879,2017
296,Ice Age,383257136,176387405,0.4602325395449388,206869731,0.5397674604550612,2002
297,Fifty Shades Darker,381545846,114581250,0.3003079477898444,266964596,0.6996920522101556,2017
298,Monsters vs. Aliens,381509870,198351526,0.5199119121085911,183158344,0.48008808789140894,2009
299,Black Widow,379192284,183647459,0.4843122256148018,195544825,0.5156877743851982,2021
300,Slumdog Millionaire,378410113,141319928,0.37345705927262046,237090185,0.6265429407273796,2008
301,Taken 2,376141306,139854287,0.3718131584304118,236287019,0.6281868415695883,2012
302,G.I. Joe: Retaliation,375740705,122523060,0.3260840743884802,253217645,0.6739159256115198,2013
303,Spider-Man: Into the Spider-Verse,375540831,190241310,0.5065795628491859,185299521,0.49342043715081413,2018
304,Mad Max: Fury Road,374736354,153636354,0.4099851865453118,221100000,0.5900148134546882,2015
305,Shark Tale,374583879,160861908,0.42944162047080514,213721971,0.5705583795291949,2004
306,Once Upon a Time... In Hollywood,374375059,142502728,0.3806416174748436,231872331,0.6193583825251564,2019
307,What Women Want,374111707,182811707,0.4886554031307018,191300000,0.5113445968692982,2000
308,The Adventures of Tintin,373993951,77591831,0.20746814431766036,296402120,0.7925318556823396,2011
309,Penguins of Madagascar,373515621,83850911,0.22449104210289508,289664710,0.775508957897105,2014
310,X-Men Origins: Wolverine,373062864,179883157,0.48217920988243956,193179707,0.5178207901175604,2009
311,The Golden Compass,372234864,70107728,0.188342723318899,302127136,0.811657276681101,2007
312,Fifty Shades Freed,371985018,100407760,0.26992420431298125,271577258,0.7300757956870187,2018
313,Batman Begins,371853783,205343774,0.552216444709398,166510009,0.44778355529060193,2005
314,Hitch,371594210,179495555,0.48304185094810814,192098655,0.5169581490518919,2005
315,Terminator Salvation,371353001,125322469,0.33747530964479805,246030532,0.6625246903552019,2009
316,Captain America: The First Avenger,370569774,176654505,0.4767105074252494,193915269,0.5232894925747505,2011
317,Edge of Tomorrow,370541256,100206256,0.2704321162013873,270335000,0.7295678837986127,2014
318,Gone Girl,369330363,167767189,0.4542469447604014,201563174,0.5457530552395986,2014
319,Jurassic Park III,368780809,181171875,0.49127251358679025,187608934,0.5087274864132098,2001
320,My Big Fat Greek Wedding,368744044,241438208,0.6547582582784713,127305836,0.34524174172152866,2002
321,Hello Mr. Billionaire,366961907,0,0.0,366961907,1.0,2018
322,Shazam!,365971656,140371656,0.3835588185550632,225600000,0.6164411814449369,2019
323,The Nun,365550119,117450119,0.32129689718415877,248100000,0.6787031028158412,2018
324,Alvin and the Chipmunks,365352546,217326974,0.5948418216305519,148025572,0.4051581783694481,2007
325,Tenet,363656624,58456624,0.16074675983352912,305200000,0.8392532401664708,2020
326,Night at the Museum: Secret of the Tomb,363204635,113746621,0.313175025973994,249458014,0.6868249740260061,2014
327,Ocean's Twelve,362744280,125544280,0.34609582265501193,237200000,0.6539041773449881,2004
328,Planet of the Apes,362211740,180011740,0.4969793082907804,182200000,0.5030206917092196,2001
329,The Hangover Part III,362000072,112200072,0.3099448886297459,249800000,0.6900551113702541,2013
330,Monster Hunt 2,361682618,706153,0.0019524106629862981,360976465,0.9980475893370137,2018
331,Fast & Furious,360364265,155064265,0.43029867292751683,205300000,0.5697013270724832,2009
332,Noah,359200044,101200044,0.28173728174710355,258000000,0.7182627182528964,2014
333,The Karate Kid,359126022,176591618,0.4917260437340294,182534404,0.5082739562659706,2010
334,Hotel Transylvania,358375603,148313048,0.4138480598524448,210062555,0.5861519401475552,2012
335,Minority Report,358372926,132072926,0.3685348875936013,226300000,0.6314651124063987,2002
336,Your Name.,357986087,5017246,0.014015198305737508,352968841,0.9859848016942625,2016
337,The Legend of Tarzan,356700357,126643061,0.3550404660794887,230057296,0.6449595339205113,2016
338,The Great Gatsby,353641895,144840419,0.40956804340164504,208801476,0.5904319565983549,2013
339,Dumbo,353284621,114766307,0.32485508900768145,238518314,0.6751449109923185,2019
340,"I, Robot",353133898,144801023,0.4100456620564928,208332875,0.5899543379435072,2004
341,Murder on the Orient Express,352789811,102826543,0.29146687289106543,249963268,0.7085331271089346,2017
342,X-Men: First Class,352616690,146408305,0.41520526155469273,206208385,0.5847947384453073,2011
343,The Angry Birds Movie,352333929,107509366,0.3051348653964007,244824563,0.6948651346035993,2016
344,Catch Me If You Can,352114312,164615351,0.4675054247723961,187498961,0.5324945752276039,2002
345,Now You See Me,351723989,117723989,0.3347056006464205,234000000,0.6652943993535795,2013
346,Hannibal,351692268,165092268,0.46942251229702897,186600000,0.5305774877029711,2001
347,Peter Rabbit,351266433,115253424,0.3281082767165515,236013009,0.6718917232834485,2018
348,Titanic 2012 3D Release,350449521,57884114,0.16517104613191924,292565407,0.8348289538680808,2012
349,Dinosaur,349822765,137748063,0.39376529140406286,212074702,0.6062347085959372,2000
350,Mary Poppins Returns,349537494,171958438,0.4919599211865952,177579056,0.5080400788134047,2018
351,The Lorax,348840316,214030500,0.6135486358176558,134809816,0.3864513641823441,2012
352,The Maze Runner,348319861,102427862,0.2940626517992323,245891999,0.7059373482007677,2014
353,The Smurfs 2,347545360,71017784,0.2043410506185437,276527576,0.7956589493814563,2013
354,National Treasure,347512318,173008894,0.4978496733459675,174503424,0.5021503266540325,2004
355,Rush Hour 2,347325802,226164286,0.6511588966258257,121161516,0.3488411033741743,2001
356,Trolls,346864462,153707064,0.44313292608223437,193157398,0.5568670739177656,2016
357,xXx: Return of Xander Cage,346118277,44898413,0.12971985585147242,301219864,0.8702801441485276,2017
358,How the Grinch Stole Christmas,345141403,260044825,0.7534443064195344,85096578,0.24655569358046564,2000
359,Star Trek Beyond,343471816,158848340,0.462478528369268,184623476,0.537521471630732,2016
360,Alvin and the Chipmunks: Chipwrecked,342695435,133110742,0.3884228630007867,209584693,0.6115771369992133,2011
361,Wanted,342463063,134508551,0.39276805452154706,207954512,0.6072319454784529,2008
362,A Quiet Place,340939361,188024361,0.5514891576276522,152915000,0.44851084237234784,2018
363,Enchanted,340487652,127807262,0.37536533630300345,212680390,0.6246346636969966,2007
364,Over the Hedge,339795890,155019340,0.4562131107589324,184776550,0.5437868892410677,2006
365,300: Rise of an Empire,337580051,106580051,0.31571785916935,231000000,0.68428214083065,2014
366,Prince of Persia: The Sands of Time,336365676,90759676,0.2698244276267951,245606000,0.730175572373205,2009
367,The Curious Case of Benjamin Button,335802786,127509326,0.3797149139793021,208293460,0.6202850860206979,2008
368,Journey 2: The Mysterious Island,335260290,103860290,0.30979001420060814,231400000,0.6902099857993919,2012
369,The Great Wall,334933831,45540830,0.13596963276008986,289393001,0.8640303672399101,2016
370,Now You See Me 2,334897606,65075540,0.19431473630778956,269822066,0.8056852636922105,2016
371,Never Say Die,334530869,0,0.0,334530869,1.0,2017
372,Fantastic Four,333535934,154696080,0.46380633758040596,178839854,0.5361936624195941,2005
373,The Good Dinosaur,332207671,123087120,0.3705125761530052,209120551,0.6294874238469947,2015
374,22 Jump Street,331333876,191719337,0.5786288420445123,139614539,0.4213711579554878,2014
375,Meet the Parents,330444045,166244045,0.5030928761327806,164200000,0.49690712386721936,2000
376,Black Swan,329398046,106954678,0.32469736629828094,222443368,0.6753026337017191,2010
377,The Perfect Storm,328718434,182618434,0.5555466779815579,146100000,0.44445332201844207,2000
378,Crazy Alien,327598891,0,0.0,327598891,1.0,2019
379,John Wick: Chapter 3 - Parabellum,326709727,171015687,0.5234484096030603,155694040,0.47655159039693973,2019
380,The Devil Wears Prada,326705902,124740460,0.38181269219923675,201965442,0.6181873078007633,2006
381,Taken 3,326479141,89256424,0.27339089329446625,237222717,0.7266091067055338,2015
382,Free Guy,326065642,119681287,0.3670466052967335,206384355,0.6329533947032665,2021
383,A Christmas Carol,325286646,137855863,0.4237981014443489,187430783,0.5762018985556512,2009
384,The SpongeBob Movie: Sponge Out of Water,325186032,162994032,0.5012331894993571,162192000,0.4987668105006429,2015
385,Megamind,321885765,148415853,0.4610823749848024,173469912,0.5389176250151976,2010
386,Green Book,321752656,85080171,0.26442725308847176,236672485,0.7355727469115282,2018
387,Robin Hood,321669741,105269730,0.327260281532045,216400011,0.672739718467955,2010
388,Inglourious Basterds,321455689,120540719,0.37498393441094147,200914970,0.6250160655890585,2009
389,The Conjuring 2,320392818,102470008,0.31982617038562955,217922810,0.6801738296143705,2016
390,Sonic the Hedgehog,319715683,148974665,0.46595982906475064,170741018,0.5340401709352494,2020
391,The Last Airbender,319713881,131772187,0.4121566026093187,187941694,0.5878433973906814,2010
392,The Conjuring,319494638,137400141,0.4300546070510266,182094497,0.5699453929489734,2013
393,The Proposal,317375031,163958031,0.5166065852231456,153417000,0.4833934147768543,2009
394,The Expendables 2,314975955,85028192,0.26995137454222495,229947763,0.730048625457775,2012
395,Chicken Little,314432837,135386665,0.4305741928601433,179046172,0.5694258071398567,2005
396,A Beautiful Mind,313542341,170742341,0.5445591190505272,142800000,0.45544088094947277,2001
397,No Time to Die,313276372,56007372,0.17877943249419398,257269000,0.8212205675058061,2021
398,Maze Runner: The Scorch Trials,312296056,81697192,0.2616017411375826,230598864,0.7383982588624174,2015
399,Resident Evil: The Final Chapter,312242626,26830068,0.085926986791355,285412558,0.914073013208645,2016
400,The Lego Batman Movie,311950384,175750384,0.5633921066114155,136200000,0.4366078933885845,2017
401,Knives Out,311605581,165363234,0.5306812332093628,146242347,0.46931876679063717,2019
402,Ocean's Thirteen,311312624,117154724,0.376325002483677,194157900,0.623674997516323,2007
403,Little Fockers,310650585,148438600,0.47783138731253316,162211985,0.5221686126874668,2010
404,Bolt,309979994,114053579,0.3679385160579105,195926415,0.6320614839420895,2008
405,The Blind Side,309208309,255959475,0.8277897700349314,53248834,0.17221022996506863,2009
406,The Ex-File 3: The Return of The Exes,307592427,838959,0.002727502130603495,306753468,0.9972724978693965,2017
407,The Fault in Our Stars,307166834,124872350,0.40652940414784494,182294484,0.593470595852155,2014
408,The Pursuit of Happyness,307127625,163566459,0.5325683712105025,143561166,0.4674316287894975,2006
409,Rise of the Guardians,306941670,103412758,0.33691338813657984,203528912,0.6630866118634202,2012
410,Chicago,306776732,170687518,0.556390039385386,136089214,0.443609960614614,2002
411,Annabelle: Creation,306515884,102092201,0.33307311734617967,204423683,0.6669268826538203,2017
412,Wonder,305937718,132422809,0.43284237676114196,173514909,0.5671576232388581,2017
413,Skyscraper,304868961,68420120,0.22442468323300382,236448841,0.7755753167669962,2018
414,A Good Day to Die Hard,304654182,67349198,0.22106769569964413,237304984,0.7789323043003559,2013
415,Dangal,303723636,12391761,0.04079946217949267,291331875,0.9592005378205073,2016
416,Passengers,303144152,100014699,0.3299245535173642,203129453,0.6700754464826357,2016
417,Battleship,303025485,65422625,0.21589809517176417,237602860,0.7841019048282358,2012
418,G.I. Joe: The Rise of Cobra,302469017,150201498,0.49658473945448767,152267519,0.5034152605455123,2009
419,Wrath of the Titans,301970083,83670083,0.27708070338875257,218300000,0.7229192966112474,2012
420,Fantastic 4: Rise of the Silver Surfer,301913131,131921738,0.436952634564278,169991393,0.563047365435722,2007
421,Resident Evil: Afterlife,300228084,60128566,0.20027628727764188,240099518,0.7997237127223581,2010
422,Van Helsing,300157638,120177084,0.4003798963796483,179980554,0.5996201036203517,2004
423,Alice Through the Looking Glass,299457024,77041381,0.257270241889534,222415643,0.7427297581104659,2016
424,Real Steel,299268508,85468508,0.28559138604720813,213800000,0.7144086139527919,2011
425,Horton Hears a Who!,298572799,154529439,0.5175603387768757,144043360,0.48243966122312437,2008
426,Ocean's Eight,297718711,140218711,0.47097715333048046,157500000,0.5290228466695195,2018
427,A Quiet Place Part II,297372261,160072261,0.5382891479578857,137300000,0.4617108520421143,2021
428,The Divergent Series: Insurgent,297002527,130179072,0.4383096444159211,166823455,0.5616903555840789,2015
429,Austin Powers in Goldmember,296938801,213307889,0.7183564030084435,83630912,0.2816435969915565,2002
430,Miss Peregrine's Home for Peculiar Children,296482446,87242834,0.29425969455203427,209239612,0.7057403054479657,2016
431,X-Men,296339528,157299718,0.5308090994867212,139039810,0.46919090051327883,2000
432,Ferdinand,296069199,84410380,0.28510355107894897,211658819,0.7148964489210511,2017
433,Shutter Island,294804195,128012934,0.4342303677191568,166791261,0.5657696322808432,2010
434,Bee Movie,293514336,126631277,0.431431318571097,166883059,0.568568681428903,2007
435,Salt,293503354,118311368,0.4031005655901295,175191986,0.5968994344098705,2010
436,G-Force,292817841,119436770,0.4078876122852091,173381071,0.5921123877147909,2009
437,The Departed,291465034,132384315,0.45420307603690124,159080719,0.5457969239630988,2006
438,What Lies Beneath,291420351,155464351,0.533471154181679,135956000,0.46652884581832105,2000
439,Pacific Rim: Uprising,290930148,59874525,0.20580378283793402,231055623,0.794196217162066,2018
440,Sex and the City 2,290745055,95347692,0.3279426093764518,195397363,0.6720573906235482,2010
441,The Bourne Supremacy,290633422,176241941,0.6064063100079384,114391481,0.39359368999206157,2004
442,Divergent,288885818,150947895,0.5225174985917792,137937923,0.47748250140822074,2014
443,Wedding Crashers,288467645,209255921,0.7254051697894923,79211724,0.2745948302105077,2005
444,Bridesmaids,288383523,169106725,0.5863952393701772,119276798,0.4136047606298228,2011
445,Maze Runner: The Death Cure,288175335,58032443,0.2013789382772818,230142892,0.7986210617227182,2018
446,American Pie 2,287553595,145103595,0.5046140876798985,142450000,0.4953859123201016,2001
447,Pitch Perfect 2,287144079,184296230,0.6418249355578737,102847849,0.35817506444212627,2015
448,Oblivion,286168572,89107235,0.3113802273158074,197061337,0.6886197726841926,2013
449,Elysium,286140700,93050117,0.3251900795657521,193090583,0.6748099204342479,2013
450,The Polar Express,286000505,162775358,0.5691436034352457,123225147,0.43085639656475433,2004
451,John Carter,284139100,73078100,0.2571912841280908,211061000,0.7428087158719092,2012
452,Turbo,282570682,83028128,0.29383136074959115,199542554,0.7061686392504088,2013
453,Paddington,282370135,76271832,0.2701129565277858,206098303,0.7298870434722142,2014
454,Bridget Jones's Diary,281929795,71543427,0.25376327110087815,210386368,0.7462367288991218,2001
455,The Tourist,278780441,67631157,0.24259649191099458,211149284,0.7574035080890055,2010
456,Split,278454358,138291365,0.4966392553281569,140162993,0.5033607446718431,2017
457,Scary Movie,278019771,157019771,0.5647791537818366,121000000,0.43522084621816337,2000
458,xXx,277448382,142109382,0.5122011560334131,135339000,0.4877988439665869,2002
459,The Bourne Legacy,276144750,113203870,0.4099439514964525,162940880,0.5900560485035475,2012
460,Mr. Peabody & Sherman,275698039,111506430,0.4044512989807664,164191609,0.5955487010192336,2014
461,Scooby-Doo,275650703,153294164,0.556117442588202,122356539,0.44388255741179805,2002
462,Lincoln,275293450,182207973,0.6618681737614898,93085477,0.33813182623851024,2012
463,Spirited Away,274925095,10055859,0.03657672283426873,264869236,0.9634232771657313,2001
464,Lara Croft: Tomb Raider,274703340,131168070,0.4774898987394911,143535270,0.5225101012605089,2001
465,Tomb Raider,274650803,58250803,0.21209041577060309,216400000,0.7879095842293969,2018
466,The Expendables,274470394,103068524,0.3755178199656754,171401870,0.6244821800343245,2010
467,Cloudy with a Chance of Meatballs 2,274325949,119793567,0.43668332302023677,154532382,0.5633166769797632,2013
468,Bad Boys II,273339556,138608444,0.5070925190205547,134731112,0.4929074809794452,2003
469,Lilo & Stitch,273144151,145794338,0.5337633534023578,127349813,0.46623664659764213,2002
470,Grown Ups,271430189,162001186,0.5968429178671795,109429003,0.40315708213282053,2010
471,Neighbors,270665134,150157400,0.5547718606416444,120507734,0.44522813935835565,2014
472,We're the Millers,269994119,150394119,0.5570273884373015,119600000,0.4429726115626985,2012
473,Gran Torino,269958228,148095302,0.5485859908667055,121862926,0.4514140091332945,2008
474,"10,000 BC",269784201,94784201,0.35133340146927283,175000000,0.6486665985307272,2008
475,American Gangster,269755430,130164645,0.4825283591140315,139590785,0.5174716408859684,2007
476,Epic,268426634,107518682,0.4005514668861064,160907952,0.5994485331138936,2013
477,Exodus: Gods and Kings,268175631,65014513,0.24243259075243864,203161118,0.7575674092475614,2014
478,The Princess and the Frog,267045765,104400899,0.3909475928217772,162644866,0.6090524071782228,2009
479,Something's Gotta Give,265328738,124728738,0.4700913249736257,140600000,0.5299086750263743,2003
480,Bridget Jones: The Edge of Reason,265126918,40226215,0.15172437149516443,224900703,0.8482756285048355,2004
481,The Incredible Hulk,264770996,134806913,0.5091453181677045,129964083,0.4908546818322956,2008
482,Charlie's Angels,264105545,125305545,0.47445253373987284,138800000,0.5255474662601272,2000
483,Borat: Cultural Learnings of America for Make Benefit Glorious Nation of Kazakhstan,262552893,128505958,0.48944788431639946,134046935,0.5105521156836006,2006
484,Robots,262511490,128200012,0.48835962189693105,134311478,0.511640378103069,2005
485,Knight and Day 2010 Re-release,261930436,76423035,0.2917684411444266,185507401,0.7082315588555734,2010
486,This Is It,261183588,72091016,0.27601663853396485,189092572,0.7239833614660351,2009
487,Terminator: Dark Fate,261119292,62253077,0.23840856998034446,198866215,0.7615914300196556,2019
488,The Lone Ranger,260502115,89302115,0.34280763900899613,171200000,0.6571923609910039,2013
489,Super 8,260095986,127004179,0.4882973434276683,133091807,0.5117026565723317,2011
490,Mojin: The Lost Legend,259368448,1243810,0.004795533186827721,258124638,0.9952044668131723,2015
491,Blade Runner 2049,259239658,92054159,0.35509288860425825,167185499,0.6449071113957418,2017
492,Charlie's Angels: Full Throttle,259175788,100830111,0.38904139841951596,158345677,0.6109586015804841,2003
493,Parasite,258633992,53369749,0.20635241557884626,205264243,0.7936475844211537,2019
494,Rush Hour 3,258097122,140125968,0.542919529339037,117971154,0.457080470660963,2007
495,Kung Fu Yoga,257743016,362657,0.0014070487946800467,257380359,0.99859295120532,2017
496,Annabelle,257047661,84273813,0.3278528684997449,172773848,0.6721471315002551,2014
497,The Village,256697520,114197520,0.44487192552541993,142500000,0.55512807447458,2003
498,Lost in Hong Kong,256283912,1302281,0.005081399725161055,254981631,0.9949186002748389,2015
499,Erin Brockovich,256271286,125595205,0.4900869190627935,130676081,0.5099130809372066,2000
500,Pegasus,255863112,0,0.0,255863112,1.0,2019
501,Marley & Me,255743093,143153751,0.5597560791211671,112589342,0.4402439208788329,2008
502,Halloween,255485178,159342015,0.6236839892136522,96143163,0.37631601078634785,2018
503,Get Out,255407969,176040665,0.6892528282858708,79367304,0.31074717171412924,2017
504,Us,255184580,175084580,0.6861095603817441,80100000,0.3138904396182559,2019
505,Baahubali 2: The Conclusion,254158390,20186659,0.07942550706274147,233971731,0.9205744929372586,2017
506,Men in Black: International,253890701,80001807,0.31510333653377876,173888894,0.6848966634662212,2019
507,Wild Hogs,253625427,168273550,0.6634727124579666,85351877,0.33652728754203337,2007
508,High School Musical 3: Senior Year,252909177,90559416,0.3580708975222358,162349761,0.6419291024777641,2008
509,X-Men: Dark Phoenix,252442974,65845974,0.26083504308580996,186597000,0.73916495691419,2019
510,True Grit,252276927,171243005,0.6787898007018296,81033922,0.32121019929817046,2010
511,American Hustle,251171807,150117807,0.5976698133162692,101054000,0.4023301866837308,2013
512,Eragon,250425512,75030163,0.2996107002069342,175395349,0.7003892997930659,2006
513,Brother Bear,250397798,85336277,0.34080282527085165,165061521,0.6591971747291484,2003
514,The Ring,249348933,129128133,0.5178611813029094,120220800,0.48213881869709063,2002
515,Unbreakable,248118121,95011339,0.3829278515292319,153106782,0.6170721484707681,2000
516,Journey to the West: The Demons Strike Back,247585244,880346,0.0035557288704976295,246704898,0.9964442711295024,2017
517,Glass,246999039,111048468,0.44959068848846817,135950571,0.5504093115115318,2019
518,Grown Ups 2,246984278,133668525,0.5412025659382255,113315753,0.4587974340617746,2013
519,The Peanuts Movie,246233113,130178411,0.5286795484732388,116054702,0.47132045152676116,2015
520,Rango,245724603,123477607,0.5025040451484624,122246996,0.4974959548515376,2011
521,Teenage Mutant Ninja Turtles: Out of the Shadows,245623848,82051601,0.3340538863311025,163572247,0.6659461136688974,2016
522,Dark Shadows,245527149,79727149,0.3247182616045446,165800000,0.6752817383954554,2012
523,Dolittle,245461868,77047065,0.3138860859642769,168414803,0.6861139140357231,2020
524,Hulk,245285165,132177234,0.5388717006183394,113107931,0.4611282993816605,2003
525,The Bravest,245179562,290217,0.0011836916488169597,244889345,0.9988163083511831,2019
526,Welcome to the Sticks,245144417,0,0.0,245144417,1.0,2008
527,Love Actually,244931766,59696144,0.24372560968674026,185235622,0.7562743903132597,2003
528,Pixels,244874809,78747585,0.3215830379677805,166127224,0.6784169620322195,2015
529,Hercules,244819862,72688614,0.29690652304999665,172131248,0.7030934769500033,2014
530,Journey to the Center of the Earth,244232688,101704370,0.41642407014739974,142528318,0.5835759298526002,2008
531,After Earth,243611982,60522097,0.24843645416422908,183089885,0.7515635458357709,2013
532,Cloudy with a Chance of Meatballs,243006126,124870275,0.513856490185766,118135851,0.48614350981423404,2009
533,8 Mile,242875078,116750901,0.48070350388111865,126124177,0.5192964961188813,2002
534,Daddy's Home,242786137,150357137,0.6192986916711806,92429000,0.38070130832881943,2015
535,RoboCop,242688965,58607007,0.24149020125410317,184081958,0.7585097987458969,2014
536,Alien: Covenant,240891763,74262031,0.3082796608533269,166629732,0.6917203391466731,2017
537,Sully,240797623,125070033,0.5193989518742052,115727590,0.48060104812579485,2016
538,Assassin's Creed,240697856,54647948,0.2270396126835463,186049908,0.7729603873164537,2016
539,Click,240685326,137355633,0.570685530699948,103329693,0.42931446930005196,2006
540,Legend of Deification,240663149,214670,0.0008919936471038197,240448479,0.9991080063528962,2020
541,Resident Evil: Retribution,240159255,42345531,0.17632271136084263,197813724,0.8236772886391573,2012
542,Planes,239258712,90288712,0.37736854489127236,148970000,0.6226314551087276,2013
543,Crazy Rich Asians,238532921,174532921,0.7316932198218459,64000000,0.2683067801781541,2018
544,Gulliver's Travels,237382724,42779261,0.1802121918526809,194603463,0.8197878081473191,2010
545,Gone in 60 Seconds,237202299,101648571,0.4285311374659147,135553728,0.5714688625340854,2000
546,Silver Linings Playbook,236412453,132092958,0.5587394247797937,104319495,0.44126057522020634,2012
547,2 Fast 2 Furious,236350661,127154901,0.5379925762086191,109195760,0.4620074237913809,2003
548,Hidden Figures,235956898,169607287,0.7188062245164792,66349611,0.2811937754835207,2016
549,A.I. Artificial Intelligence,235926552,78616689,0.33322527004082186,157309863,0.6667747299591782,2001
550,Spy,235666219,110825712,0.47026558354551445,124840507,0.5297344164544856,2015
551,Howl's Moving Castle,235347345,4711096,0.020017629686878344,230636249,0.9799823703131216,2004
552,American Reunion,234989584,57011521,0.24261297045404362,177978063,0.7573870295459564,2012
553,Alvin and the Chipmunks: The Road Chip,234798636,85886987,0.3657899741802589,148911649,0.6342100258197412,2015
554,The Imitation Game,233555708,91125683,0.39016679909188945,142430025,0.6098332009081106,2014
555,Cruella,233274812,86103234,0.36910643400282755,147171578,0.6308935659971725,2021
556,The Day the Earth Stood Still,233093859,79366978,0.34049364638130597,153726881,0.659506353618694,2008
557,American Wedding,232722935,104565114,0.4493115987902095,128157821,0.5506884012097906,2003
558,The Girl with the Dragon Tattoo,232617430,102515793,0.44070555246010584,130101637,0.5592944475398941,2011
559,Juno,232372681,143495265,0.6175220958956015,88877416,0.3824779041043986,2007
560,Argo,232325503,136025503,0.5854953556261105,96300000,0.4145046443738895,2012
561,Mr. Bean's Holiday,232225908,33302167,0.14340418468726582,198923741,0.8565958153127342,2007
562,Annabelle Comes Home,231252591,74152591,0.32065626023623667,157100000,0.6793437397637634,2019
563,Constantine,230884728,75976178,0.32906541137705736,154908550,0.6709345886229426,2005
564,Get Smart,230685453,130319208,0.5649216554630343,100366245,0.43507834453696564,2008
565,Ghostbusters,229147509,128350574,0.5601220565744837,100796935,0.43987794342551634,2016
566,Ghost Rider,228738393,115802596,0.5062665452930764,112935797,0.49373345470692365,2007
567,Goodbye Mr. Loser,228122928,1293626,0.005670740820931423,226829302,0.9943292591790686,2015
568,Paddington 2,227978523,40891591,0.17936597913655225,187086932,0.8206340208634477,2017
569,The Green Hornet,227817248,98780042,0.4335933423267408,129037206,0.5664066576732593,2011
570,Youth,227091290,1891956,0.00833125744276674,225199334,0.9916687425572333,2017
571,Baby Driver,226945087,107825862,0.47511873213628986,119119225,0.5248812678637101,2017
572,Immortals,226904017,83504017,0.3680147143450528,143400000,0.6319852856549473,2011
573,Taken,226837760,145000989,0.6392277414483374,81836771,0.3607722585516627,2008
574,Percy Jackson & the Olympians: The Lightning Thief,226497209,88768303,0.39191786685548075,137728906,0.6080821331445192,2010
575,Hansel & Gretel: Witch Hunters,226349749,55703475,0.2460947062945495,170646274,0.7539052937054505,2013
576,Better Days,225918798,1921657,0.008505963279779843,223997141,0.9914940367202202,2019
577,Valerian and the City of a Thousand Planets,225874228,41189488,0.18235585513545174,184684740,0.8176441448645483,2017
578,Ford v Ferrari,225508210,117624357,0.521596783549477,107883853,0.47840321645052303,2019
579,Jumper,225132113,80172128,0.3561114713119581,144959985,0.6438885286880419,2008
580,The Social Network,224920315,96962694,0.4310979824121267,127957621,0.5689020175878733,2010
581,Chicken Run,224834564,106834564,0.47516966297050306,118000000,0.524830337029497,2000
582,Flightplan,223387299,89707299,0.40157743704130644,133680000,0.5984225629586936,2005
583,Yes Man,223241637,97690976,0.43760195146750336,125550661,0.5623980485324966,2008
584,Non-Stop,222809600,92168600,0.4136652998793589,130641000,0.5863347001206412,2014
585,Fahrenheit 9/11,222446882,119194771,0.5358347571713772,103252111,0.4641652428286228,2004
586,Geostorm,221600160,33700160,0.15207642449355632,187900000,0.8479235755064437,2017
587,Scary Movie 3,220673217,110003217,0.4984892072335176,110670000,0.5015107927664824,2003
588,Elf,220443451,173398518,0.7865895639603283,47044933,0.2134104360396717,2003
589,Collateral,220239925,101005703,0.4586166790603475,119234222,0.5413833209396525,2004
590,Inferno,220021259,34343574,0.15609207108482184,185677685,0.8439079289151782,2016
591,Knocked Up,219922417,148768917,0.6764609039377737,71153500,0.32353909606222636,2007
592,Green Lantern,219851172,116601172,0.5303641137742036,103250000,0.46963588622579644,2011
593,What Happens in Vegas,219375562,80277646,0.36593704999830384,139097916,0.6340629500016962,2008
594,It's Complicated,219103655,112735375,0.5145298694355418,106368280,0.4854701305644582,2009
595,Captain Phillips,218791811,107100855,0.4895103455220269,111690956,0.5104896544779731,2013
596,The Terminal,218685607,77872883,0.35609514530144637,140812724,0.6439048546985536,2004
597,Jack Reacher,218340595,80070736,0.3667239983476275,138269859,0.6332760016523725,2012
598,Kingdom of Heaven,218122627,47398413,0.2173016786561992,170724214,0.7826983213438008,2005
599,The Emoji Movie,217776646,86089513,0.39531104267259215,131687133,0.6046889573274078,2017
600,Dracula Untold,217124280,56280355,0.2592080213230874,160843925,0.7407919786769126,2014
601,Central Intelligence,216972543,127440871,0.5873594383783389,89531672,0.412640561621661,2016
602,Million Dollar Baby,216763646,100492203,0.4636026605679072,116271443,0.5363973394320928,2004
603,The Help,216639112,169708112,0.7833678343363962,46931000,0.21663216566360372,2011
604,Little Women,216601214,108101214,0.4990794465260938,108500000,0.5009205534739062,2019
605,Valentine's Day,216485654,110485654,0.5103601645585254,106000000,0.48963983544147455,2010
606,Bad Teacher,216197492,100292856,0.46389463204318765,115904636,0.5361053679568124,2011
607,A Little Red Flower,216000000,0,0.0,216000000,1.0,2020
608,The Croods: A New Age,215905815,58568815,0.271270206409216,157337000,0.728729793590784,2020
609,Ted 2,215863606,81476385,0.37744382441197616,134387221,0.6225561755880239,2015
610,Vertical Limit,215663859,69243859,0.3210730778957266,146420000,0.6789269221042734,2000
611,The Patriot,215294342,113330342,0.5263972148418095,101964000,0.47360278515819054,2000
612,The Sorcerer's Apprentice,215283742,63150991,0.29333841196424393,152132751,0.7066615880357561,2010
613,Just Go with It,214945591,103028109,0.4793218066054679,111917482,0.5206781933945321,2011
614,The Expendables 3,214657577,39322544,0.18318730952599918,175335033,0.8168126904740008,2014
615,Creed II,214215889,115715889,0.5401835015142131,98500000,0.45981649848578693,2018
616,Public Enemies,214104620,97104620,0.453538181474085,117000000,0.546461818525915,2009
617,Smallfoot,214040103,83240103,0.3888995652370808,130800000,0.6111004347629192,2018
618,The Bourne Identity,214034224,121661683,0.5684216324208039,92372541,0.4315783675791961,2002
619,The Aviator,213719942,102610330,0.4801158424420684,111109612,0.5198841575579316,2004
620,"Crouching Tiger, Hidden Dragon",213525736,128078872,0.5998287344622477,85446864,0.40017126553775234,2000
621,Into the Woods,212902372,128002372,0.6012256735213829,84900000,0.39877432647861716,2014
622,Bedtime Stories,212874864,110101975,0.5172145406514506,102772889,0.4827854593485495,2008
623,Miss Congeniality,212742720,106807667,0.502050866887478,105935053,0.49794913311252204,2000
624,Bridget Jones's Baby,211952420,24252420,0.11442388815376583,187700000,0.8855761118462342,2016
625,Battle Los Angeles,211819354,83552429,0.3944513446113144,128266925,0.6055486553886856,2011
626,Fury,211817906,85817906,0.4051494400100433,126000000,0.5948505599899566,2014
627,Australia,211787511,49554002,0.23397981196351092,162233509,0.7660201880364891,2008
628,Due Date,211780824,100539043,0.47473156965335067,111241781,0.5252684303466493,2010
629,Jungle Cruise,211760909,116546419,0.5503679576668232,95214490,0.4496320423331768,2021
630,Master and Commander: The Far Side of the World,211622535,93927920,0.44384649300226936,117694615,0.5561535069977307,2003
631,A Series of Unfortunate Events,211468235,118634549,0.5610041101444858,92833686,0.43899588985551424,2004
632,District 9,210888950,115646235,0.5483750334002802,95242715,0.4516249665997199,2009
633,The Others,209947037,96522687,0.4597477934399236,113424350,0.5402522065600764,2001
634,Horrible Bosses,209838559,117538559,0.5601380392628411,92300000,0.4398619607371589,2011
635,Us and Them,209221380,0,0.0,209221380,1.0,2018
636,Red Dragon,209196298,93149898,0.44527507843374936,116046400,0.5547249215662506,2002
637,Tomorrowland,209035668,93436322,0.44698745861878464,115599346,0.5530125413812154,2015
638,Me Before You,208314186,56245075,0.2700011750519957,152069111,0.7299988249480043,2016
639,Safe House,208076205,126373434,0.6073420745058283,81702771,0.3926579254941717,2012
640,S.W.A.T.,207725639,116934650,0.562928344151104,90790989,0.43707165584889596,2003
641,Traffic,207515725,124115725,0.5981027461894756,83400000,0.4018972538105245,2000
642,The Fast and the Furious,207283925,144533925,0.697275126375574,62750000,0.302724873624426,2001
643,Paranormal Activity 3,207039844,104028807,0.5024579085366776,103011037,0.4975420914633224,2011
644,The Holiday,205841885,63224849,0.3071524971703402,142617036,0.6928475028296598,2006
645,Raging Fire,205823405,378654,0.0018397033126529025,205444751,0.9981602966873471,2021
646,London Has Fallen,205754447,62524260,0.30387804935268303,143230187,0.696121950647317,2016
647,The Break-Up,205668210,118703275,0.5771590806376931,86964935,0.4228409193623069,2006
648,Journey to the West,205637183,18058,8.781485788005567e-05,205619125,0.99991218514212,2013
649,White House Down,205366737,73103784,0.35596701329485503,132262953,0.644032986705145,2013
650,The Ugly Truth,205298907,88915214,0.43310125367593894,116383693,0.566898746324061,2009
651,A Dog's Purpose,205035819,64508620,0.3146212223533489,140527199,0.6853787776466511,2017
652,Fun with Dick and Jane,204681899,110332737,0.5390449157402043,94349162,0.46095508425979576,2005
653,Eat Pray Love,204594016,80574010,0.39382388388133505,124020006,0.606176116118665,2010
654,You Don't Mess with the Zohan,204313400,100018837,0.48953635444371246,104294563,0.5104636455562875,2008
655,Ponyo,204171810,15090399,0.07391029643122624,189081411,0.9260897035687737,2008
656,King Arthur,203567857,51882244,0.2548646174528428,151685613,0.7451353825471573,2004
657,Hairspray,203552922,118871849,0.5839849795916956,84681073,0.4160150204083044,2007
658,Yogi Bear,203509374,100246011,0.49258670020772605,103263363,0.5074132997922739,2010
659,Everest,203427584,43482270,0.2137481512831613,159945314,0.7862518487168387,2015
660,Vanilla Sky,203388341,100618344,0.4947104809709815,102769997,0.5052895190290185,2001
661,Arrival,203388186,100546139,0.49435584719753584,102842047,0.5056441528024641,2016
662,Need for Speed,203277636,43577636,0.2143749644943726,159700000,0.7856250355056273,2014
663,Garfield,203172417,75369589,0.3709636874576336,127802828,0.6290363125423665,2004
664,The Addams Family,203044905,100044905,0.49272305059809307,103000000,0.5072769494019069,2019
665,The Conjuring: The Devil Made Me Do It,201965074,65565074,0.32463570409208475,136400000,0.6753642959079152,2021
666,Birds of Prey,201858461,84158461,0.41691817416561006,117700000,0.5830818258343899,2020
667,Straight Outta Compton,201634991,161197785,0.7994534291917617,40437206,0.20054657080823834,2015
668,21 Jump Street,201585328,138447667,0.6867943633278708,63137661,0.31320563667212925,2012
669,Valkyrie,201545517,83077833,0.41220382490571594,118467684,0.5877961750942841,2008
670,Open Season,200811689,85105259,0.4238063004390148,115706430,0.5761936995609852,2006
671,Cats & Dogs,200687492,93385515,0.46532802851510047,107301977,0.5346719714848995,2001
672,Percy Jackson: Sea of Monsters,199850315,68559554,0.34305452057956476,131290761,0.6569454794204352,2013
673,Two Weeks Notice,199043242,93354851,0.469017938323171,105688391,0.530982061676829,2002
674,RED,199006387,90380162,0.45415709195303366,108626225,0.5458429080469663,2010
675,Shock Wave 2,198921659,0,0.0,198921659,1.0,2020
676,The Pacifier,198636868,113086868,0.5693145947105851,85550000,0.43068540528941485,2005
677,Total Recall,198467168,58877969,0.296663521696445,139589199,0.703336478303555,2012
678,50 First Dates,198413428,120908074,0.6093744522170143,77505354,0.39062554778298575,2004
679,The Island,198326350,670883,0.0033827224672868736,197655467,0.9966172775327131,2018
680,The Impossible,198087212,19019882,0.09601771769093302,179067330,0.903982282309067,2012
681,Lost in Thailand,197757387,57387,0.00029018890707733716,197700000,0.9997098110929227,2012
682,Christopher Robin,197744377,99215042,0.5017338217409844,98529335,0.4982661782590157,2018
683,Jack the Giant Slayer,197687603,65187603,0.3297505863329225,132500000,0.6702494136670776,2013
684,Smurfs: The Lost Village,197183546,45020282,0.22831662637814618,152163264,0.7716833736218538,2017
685,Chinese Doctors,197143218,0,0.0,197143218,1.0,2021
686,Spy Kids 3-D: Game Over,197011982,111761982,0.567285201973147,85250000,0.43271479802685303,2003
687,The Other Woman,196710396,83911193,0.4265722336301941,112799203,0.5734277663698059,2014
688,Panic Room,196397415,96397334,0.49082791644686363,100000081,0.5091720835531364,2002
689,Beowulf,196393745,82280579,0.41895722799114604,114113166,0.5810427720088539,2007
690,The Vow,196114570,125014030,0.6374540657535032,71100540,0.36254593424649684,2012
691,Anger Management,195745823,135645823,0.6929691827957933,60100000,0.3070308172042067,2003
692,Tropic Thunder,195702811,110515313,0.564709890651494,85187498,0.435290109348506,2008
693,The Shape of Water,195333312,63859435,0.3269254708587545,131473877,0.6730745291412455,2017
694,Rocketman,195320400,96368160,0.4933850227625993,98952240,0.5066149772374007,2019
695,The BFG,195243411,55483770,0.28417742609506036,139759641,0.7158225739049396,2016
696,The Intern,194564672,75764672,0.38940610965591943,118800000,0.6105938903440805,2015
697,Wallace & Gromit: The Curse of the Were-Rabbit,194111171,56110897,0.2890657797329964,138000274,0.7109342202670036,2005
698,Gnomeo & Juliet,193967670,99967670,0.5153831563785862,94000000,0.48461684362141383,2011
699,Weathering with You,193932489,8056636,0.04154350847319863,185875853,0.9584564915268013,2019
700,The Sum of All Fears,193921372,118907036,0.6131713837090633,75014336,0.38682861629093673,2002
701,Downton Abbey,193820755,96854135,0.49970982209825776,96966620,0.5002901779017422,2019
702,Gangs of New York,193772504,77812000,0.4015636810886234,115960504,0.5984363189113766,2002
703,The Monkey King 2,193678298,709982,0.003665779838689,192968316,0.996334220161311,2016
704,Paranormal Activity,193355800,107918810,0.5581358821405926,85436990,0.4418641178594074,2009
705,The Equalizer,192330738,101530738,0.527896575741315,90800000,0.47210342425868507,2014
706,The Lego Movie 2: The Second Part,192306508,105806508,0.5501972299346208,86500000,0.44980277006537916,2019
707,Sheep Without a Shepherd,191602146,0,0.0,191602146,1.0,2019
708,The Longest Yard,191466556,158119460,0.8258333115888918,33347096,0.17416668841110822,2005
709,The Equalizer 2,190400157,102084362,0.5361569213411941,88315795,0.4638430786588059,2018
710,Hollow Man,190213455,73209340,0.3848799234523131,117004115,0.615120076547687,2000
711,Cheaper by the Dozen,190212113,138614544,0.7287366814541406,51597569,0.2712633185458594,2003
712,The White Storm 2: Drug Lords,189396380,609461,0.003217912612690908,188786919,0.9967820873873091,2019
713,Breakup Buddies,189017596,777896,0.004115468699538428,188239700,0.9958845313004616,2014
714,The Secret Life of Walter Mitty,188133322,58236838,0.30955089391341317,129896484,0.6904491060865868,2013
715,Project Gutenberg,188116796,0,0.0,188116796,1.0,2018
716,12 Years a Slave,187733202,56671993,0.30187517389704993,131061209,0.6981248261029501,2013
717,Mr. Popper's Penguins,187361754,68224452,0.3641322230576471,119137302,0.635867776942353,2011
718,The Grudge,187281115,110359362,0.5892711713084365,76921753,0.41072882869156346,2004
719,I Now Pronounce You Chuck & Larry,187134117,120059556,0.6415695754719061,67074561,0.3584304245280939,2007
720,Walk the Line,186797986,119519402,0.6398323909123945,67278584,0.3601676090876055,2005
721,Jian Bing Man,186683536,0,0.0,186683536,1.0,2015
722,The Final Destination,186167139,66477700,0.35708611281822406,119689439,0.6429138871817759,2009
723,Atlantis: The Lost Empire,186053725,84056472,0.45178602040888993,101997253,0.5482139795911101,2001
724,Inside Man,186003591,88513495,0.47586981801872846,97490096,0.5241301819812715,2006
725,Hugo,185770160,73864507,0.39761233451055866,111905653,0.6023876654894413,2011
726,Venom: Let There Be Carnage,185565616,141665616,0.7634260002133154,43900000,0.2365739997866846,2021
727,The Lion King 2011 3D Release,185542001,94242001,0.5079281267425805,91300000,0.49207187325741947,2011
728,Pitch Perfect 3,185400345,104897530,0.5657892923554161,80502815,0.4342107076445839,2017
729,Watchmen,185382813,107509799,0.5799340147028624,77873014,0.42006598529713757,2009
730,Hop,183953723,108085305,0.5875679123928359,75868418,0.4124320876071641,2011
731,Bad Moms,183936074,113257297,0.615742711785835,70678777,0.3842572882141651,2016
732,Jupiter Ascending,183887723,47387723,0.25769922117095334,136500000,0.7423007788290467,2015
733,Knowing,183658498,79957634,0.435360382834014,103700864,0.564639617165986,2007
734,102 Dalmatians,183611771,66957026,0.36466630453665194,116654745,0.6353336954633481,2000
735,Stand by Me Doraemon,183442714,0,0.0,183442714,1.0,2014
736,Storks,183388953,72679278,0.3963121922616571,110709675,0.6036878077383429,2016
737,Paul Blart: Mall Cop,183348429,146336178,0.7981316163881611,37012251,0.20186838361183884,2009
738,Mirror Mirror,183018522,64935167,0.3548010676209045,118083355,0.6451989323790955,2012
739,The Haunted Mansion,182290266,75847266,0.41607962764177436,106443000,0.5839203723582257,2003
740,From Vegas to Macau III,181732879,0,0.0,181732879,1.0,2016
741,Poseidon,181674817,60674817,0.33397483482809837,121000000,0.6660251651719016,2006
742,Cliff Walkers,181325565,152972,0.0008436317294806168,181172593,0.9991563682705193,2021
743,Scooby-Doo 2: Monsters Unleashed,181216833,84216833,0.46472963689857666,97000000,0.5352703631014234,2004
744,Road to Perdition,181001478,104454762,0.5770934201984804,76546716,0.42290657980151963,2002
745,Kill Bill: Vol. 1,180899045,70099045,0.38750367642902706,110800000,0.612496323570973,2003
746,Sweet Home Alabama,180622424,127223418,0.7043611484252918,53399006,0.29563885157470815,2002
747,Daddy's Home 2,180613180,104029443,0.5759792447040687,76583737,0.42402075529593136,2017
748,Hacksaw Ridge,180563636,67209615,0.37222120959061766,113354021,0.6277787904093823,2016
749,Deja Vu,180557550,64038616,0.35467149393642083,116518934,0.6453285060635792,2006
750,The Post,179769457,81903458,0.4556027445752367,97865999,0.5443972554247632,2017
751,The Dictator,179379533,59650222,0.3325363880839181,119729311,0.6674636119160818,2012
752,The League of Extraordinary Gentlemen,179265204,66465204,0.37076466886457227,112800000,0.6292353311354277,2003
753,Allegiant,179246868,66184051,0.36923407219589466,113062817,0.6307659278041053,2016
754,Moulin Rouge!,179213434,57386607,0.320213756966456,121826827,0.6797862430335441,2001
755,Daredevil,179179718,102543518,0.5722942258453605,76636200,0.4277057741546395,2003
756,Abominable,179053956,60716390,0.33909549588505045,118337566,0.6609045041149496,2019
757,He's Just Not That Into You,178866158,93953653,0.5252735008709697,84912505,0.4747264991290303,2009
758,The Scorpion King,178799308,91047077,0.5092138108275005,87752231,0.4907861891724995,2002
759,Eagle Eye,178767383,101440743,0.5674454774560301,77326640,0.43255452254396987,2008
760,Along Came Polly,178311729,88097164,0.4940626423963395,90214565,0.5059373576036605,2004
761,Flushed Away,178281554,64665672,0.36271656012152553,113615882,0.6372834398784745,2006
762,Scary Movie 4,178262620,90710620,0.5088594569068939,87552000,0.4911405430931061,2006
763,Brokeback Mountain,178062759,83043761,0.46637354978870116,95018998,0.5336264502112988,2005
764,Baywatch,177856751,58060186,0.32644353207599075,119796565,0.6735564679240093,2017
765,War Horse,177584879,79884879,0.44984054639021376,97700000,0.5501594536097862,2011
766,Paranormal Activity 2,177512032,84752907,0.4774488018930458,92759125,0.5225511981069543,2010
767,How to Lose a Guy in 10 Days,177502387,105813373,0.5961236622693981,71689014,0.4038763377306019,2003
768,Alien vs. Predator,177427090,80282231,0.4524801201439983,97144859,0.5475198798560017,2004
769,Hero,177395557,53710019,0.302769809505432,123685538,0.697230190494568,2002
770,The 40-Year-Old Virgin,177378645,109449237,0.6170372820245639,67929408,0.38296271797543613,2005
771,Lee Daniels' The Butler,177313795,116632095,0.6577722562421046,60681700,0.34222774375789544,2013
772,The Descendants,177243185,82584160,0.4659370119082435,94659025,0.5340629880917566,2011
773,The A-Team,177238796,77222099,0.4356952357090036,100016697,0.5643047642909964,2010
774,The Hitman's Bodyguard,176586701,75468583,0.4273741033306919,101118118,0.5726258966693081,2017
775,Looper,176506819,66486205,0.37667782682095696,110020614,0.623322173179043,2012
776,Serial (Bad) Weddings,176404493,0,0.0,176404493,1.0,2014
777,Ip Man 4: The Finale,176345966,3956031,0.02243335126815433,172389935,0.9775666487318456,2019
778,Dr. Dolittle 2,176104344,112952899,0.6413975739292382,63151445,0.35860242607076176,2001
779,The Italian Job,176070171,106128601,0.6027630938121824,69941570,0.3972369061878176,2003
780,The Monkey King Havoc in Heavens Palace,175835580,0,0.0,175835580,1.0,2014
781,The Bucket List,175372502,93466502,0.5329598479469717,81906000,0.46704015205302823,2007
782,Cowboys & Aliens,174822325,100240551,0.5733852984737504,74581774,0.4266147015262496,2011
783,The Mule,174804407,103804407,0.5938317504775494,71000000,0.40616824952245056,2018
784,Evan Almighty,174440724,100462298,0.5759108062404052,73978426,0.4240891937595948,2007
785,Identity Thief,173965010,134506920,0.7731837568945618,39458090,0.22681624310543827,2013
786,The Nutcracker and the Four Realms,173961069,54858851,0.3153513100106323,119102218,0.6846486899893677,2018
787,Big Momma's House,173959438,117559438,0.6757864899517553,56400000,0.32421351004824467,2000
788,In Time,173930596,37520095,0.215718774401256,136410501,0.784281225598744,2011
789,Amélie,173921954,33225499,0.1910368313824257,140696455,0.8089631686175743,2001
790,Operation Mekong,173839072,800012,0.004602026407504062,173039060,0.9953979735924959,2016
791,Creed,173567581,109767581,0.6324198353608442,63800000,0.3675801646391557,2015
792,Gemini Man,173469516,48546770,0.27985764369112553,124922746,0.7201423563088745,2019
793,The Girl on the Train,173185859,75395035,0.435341750390833,97790824,0.564658249609167,2016
794,Cold Mountain,173013509,95636509,0.5527690268394013,77377000,0.4472309731605987,2003
795,Black Hawk Down,172989651,108638745,0.6280071921759065,64350906,0.3719928078240935,2001
796,The Grand Budapest Hotel,172936941,59301324,0.342907210322403,113635617,0.657092789677597,2014
797,The Santa Clause 2,172855065,139236327,0.8055090951485859,33618738,0.1944909048514141,2002
798,Cloverfield,172394180,80048433,0.46433373214803425,92345747,0.5356662678519658,2008
799,Couples Retreat,171844840,109204945,0.6354857381810243,62639895,0.3645142618189758,2009
800,Blood Diamond,171720398,57377916,0.3341357035522361,114342482,0.6658642964477639,2006
801,Jackass 3D,171685792,117229692,0.6828153374508708,54456100,0.3171846625491293,2010
802,No Country for Old Men,171627166,74283625,0.43281973787296585,97343541,0.5671802621270341,2007
803,Spies in Disguise,171616764,66757013,0.3889888810629246,104859751,0.6110111189370754,2019
804,John Wick: Chapter 2,171539887,92029184,0.5364885427492441,79510703,0.46351145725075593,2017
805,Anchorman 2: The Legend Continues,171464676,125168368,0.7299950690718361,46296308,0.2700049309281639,2013
806,Mr. Deeds,171269535,126293452,0.7373958947223159,44976083,0.2626041052776841,2002
807,Superbad,170812526,121463226,0.7110908599290897,49349300,0.28890914007091023,2007
808,Chinese Zodiac,170525083,0,0.0,170525083,1.0,2012
809,The Other Guys,170458922,119219978,0.6994059131736149,51238944,0.30059408682638505,2010
810,Olympus Has Fallen,170270201,98925640,0.5809920903305916,71344561,0.4190079096694083,2013
811,Starsky & Hutch,170268750,88237754,0.5182263568623132,82030996,0.4817736431376867,2004
812,Shall We Dance,170128460,57890460,0.3402749898517861,112238000,0.6597250101482138,2004
813,Stuart Little 2,169956806,64956806,0.3821959680743824,105000000,0.6178040319256176,2002
814,Zookeeper,169852759,80360843,0.47312062207950356,89491916,0.5268793779204964,2011
815,Dumb and Dumber to,169837010,86208010,0.5075926030492411,83629000,0.49240739695075886,2014
816,Ghost in the Shell,169801921,40563557,0.23888750351652382,129238364,0.7611124964834762,2017
817,Seven Pounds,169748929,69951824,0.412089928414217,99797105,0.587910071585783,2008
818,Meet the Robinsons,169333034,97822171,0.5776910074144186,71510863,0.42230899258558136,2007
819,The Emperor's New Groove,169327687,89302687,0.5273956585729539,80025000,0.4726043414270461,2000
820,Dodgeball: A True Underdog Story,168423227,114326736,0.6788062313994256,54096491,0.3211937686005743,2004
821,Hellboy II: The Golden Army,168319243,75986503,0.4514427563104,92332740,0.5485572436896,2008
822,Insidious: The Last Key,167885588,67745330,0.40352081919026905,100140258,0.596479180809731,2018
823,Fantastic Four,167882881,56117548,0.3342660530110869,111765333,0.6657339469889131,2015
824,Unstoppable,167805466,81562942,0.48605652690717477,86242524,0.5139434730928253,2010
825,Magic Mike,167739368,113721571,0.6779658964733908,54017797,0.3220341035266092,2012
826,The Suicide Squad,167389082,55789082,0.33328984981230736,111600000,0.6667101501876926,2021
827,Alexander,167298192,34297191,0.20500634579481888,133001001,0.7949936542051811,2004
828,Up in the Air,166842739,83823381,0.5024095234974535,83019358,0.4975904765025465,2009
829,Wonder Woman 1984,166534027,46534027,0.2794265402589466,120000000,0.7205734597410534,2020
830,Nutty Professor II: The Klumps,166339890,123309890,0.7413128023590734,43030000,0.2586871976409267,2000
831,Bridge of Spies,165478348,72313754,0.4369982833041094,93164594,0.5630017166958906,2015
832,The Princess Diaries,165335153,108248956,0.6547243827814403,57086197,0.3452756172185597,2001
833,The Muppets,165184237,88631237,0.5365598958452676,76553000,0.4634401041547324,2011
834,The Huntsman: Winter's War,164989338,48390190,0.2932928308373478,116599148,0.7067071691626522,2016
835,Saw III,164874275,80238724,0.4866661218070557,84635551,0.5133338781929443,2006
836,Bringing Down the House,164729679,132716677,0.8056634226792854,32013002,0.19433657732071463,2003
837,Daddy Day Care,164433867,104297061,0.6342796827857853,60136806,0.3657203172142148,2003
838,The Spiderwick Chronicles,164170327,71195053,0.43366578054023125,92975274,0.5663342194597688,2008
839,The Pink Panther,164115897,82226474,0.5010268688352597,81889423,0.49897313116474024,2006
840,Four Christmases,164112721,120146040,0.7320946192830475,43966681,0.26790538071695247,2008
841,The Ring Two,163995949,76231249,0.46483617104468844,87764700,0.5351638289553116,2005
842,From Vegas to Macau II,163877532,0,0.0,163877532,1.0,2015
843,Miami Vice,163794509,63450470,0.38737849264531815,100344039,0.6126215073546818,2006
844,Burn After Reading,163728902,60355347,0.3686297670279374,103373555,0.6313702329720625,2008
845,The Happening,163403799,64506874,0.3947697323732357,98896925,0.6052302676267644,2008
846,Talladega Nights: The Ballad of Ricky Bobby,163362095,148213377,0.9072690760974876,15148718,0.09273092390251239,2006
847,World Trade Center,163247198,70278893,0.43050596801055047,92968305,0.5694940319894495,2006
848,The Island,162949164,35818913,0.21981648828833514,127130251,0.7801835117116649,2005
849,The Interpreter,162944923,72708161,0.4462131109172392,90236762,0.5537868890827609,2005
850,27 Dresses,162655351,76808654,0.47221719745328267,85846697,0.5277828025467173,2008
851,The Magnificent Seven,162360636,93432655,0.5754637164638847,68927981,0.4245362835361152,2016
852,Memoirs of a Geisha,162242962,57490508,0.35434823977141144,104752454,0.6456517602285885,2005
853,Jack Reacher: Never Go Back,162146076,58697076,0.36200121179620776,103449000,0.6379987882037922,2016
854,Insidious: Chapter 2,161919318,83586447,0.5162228203060983,78332871,0.4837771796939016,2013
855,Limitless,161849455,79249455,0.489649192825518,82600000,0.510350807174482,2011
856,Scream 3,161834276,89143175,0.5508300046400554,72691101,0.4491699953599446,2000
857,Flight,161772375,93772375,0.5796562917494411,68000000,0.42034370825055883,2012
858,Into the Storm,161502194,47602194,0.29474642307336085,113900000,0.7052535769266391,2014
859,Unbroken,161459297,115637895,0.7162046233856698,45821402,0.28379537661433024,2014
860,The Sacrifice,161047608,0,0.0,161047608,1.0,2020
861,Freaky Friday,160846332,110230332,0.6853145522771387,50616000,0.31468544772286133,2003
862,The Predator,160542134,51024708,0.3178275181018835,109517426,0.6821724818981165,2018
863,Space Jam: A New Legacy,160505446,70505446,0.43927136279226314,90000000,0.5607286372077369,2021
864,Johnny English,160466000,28082366,0.1750050851893859,132383634,0.824994914810614,2003
865,"Three Billboards Outside Ebbing, Missouri",160192031,54513740,0.3403024461310438,105678291,0.6596975538689562,2017
866,Underworld: Awakening,160112671,62321039,0.3892323987275186,97791632,0.6107676012724814,2012
867,Lara Croft Tomb Raider: The Cradle of Life,160099222,65660196,0.41012189303455826,94439026,0.5898781069654417,2003
868,Johnny English Reborn,160078586,8305970,0.051886827636021225,151772616,0.9481131723639787,2011
869,Norbit,159814490,95673607,0.5986541458161898,64140883,0.40134585418381025,2007
870,21,159808370,81159365,0.5078542819753433,78649005,0.4921457180246567,2008
871,Step Up,159291809,42400223,0.26617955603731014,116891586,0.7338204439626899,2010
872,Happy Feet Two,159196259,64006466,0.4020601137367179,95189793,0.5979398862632821,2011
873,Johnny English Strikes Again,158970776,4412170,0.02775459811556811,154558606,0.9722454018844319,2018
874,The Fast and the Furious: Tokyo Drift,158964610,62514415,0.3932599526397731,96450195,0.6067400473602269,2006
875,Focus,158762963,53862963,0.3392665517334795,104900000,0.6607334482665205,2015
876,Sin City,158733820,74103820,0.4668432977924931,84630000,0.5331567022075069,2005
877,Goosebumps,158260952,80080379,0.5060021312142745,78180573,0.4939978687857255,2015
878,Final Destination 5,157887643,42587643,0.26973385751283907,115300000,0.7302661424871609,2011
879,Don't Breathe,157761002,89217875,0.5655255346311758,68543127,0.43447446536882417,2016
880,Hustlers,157563598,104963598,0.6661665469203109,52600000,0.33383345307968915,2019
881,The Book of Eli,157107755,94835059,0.6036306673722122,62272696,0.39636933262778784,2010
882,Ip Man 3,156954938,2679437,0.01707137751855886,154275501,0.9829286224814411,2015
883,The Climbers,156892866,487157,0.0031050296448788183,156405709,0.9968949703551212,2019
884,P.S. I Love You,156835339,53695808,0.3423705928929704,103139531,0.6576294071070297,2007
885,Mystic River,156595191,90135191,0.5755936081076717,66460000,0.4244063918923283,2003
886,This Means War,156491279,54760791,0.3499287075288074,101730488,0.6500712924711926,2012
887,Rocky Balboa,155929020,70270943,0.45065981303544395,85658077,0.549340186964556,2006
888,The Hateful Eight,155760117,54117416,0.3474407765114866,101642701,0.6525592234885135,2015
889,Escape Room,155712077,57005601,0.36609620845273294,98706476,0.6339037915472671,2019
890,The Monuments Men,155641650,78031620,0.5013543611237737,77610030,0.49864563887622626,2014
891,Hannah Montana: The Movie,155545279,79576189,0.5115950127936701,75969090,0.4884049872063298,2009
892,Monster-in-Law,155457327,82931301,0.5334666599535705,72526026,0.4665333400464296,2005
893,Dreamgirls,155430335,103365956,0.6650307740763732,52064379,0.3349692259236268,2006
894,The Accountant,155160045,86260045,0.5559423819450426,68900000,0.44405761805495736,2016
895,Bayside Shakedown 2,155138312,0,0.0,155138312,1.0,2003
896,Blade II,155010032,82348319,0.5312450938659248,72661713,0.4687549061340752,2002
897,Maid in Manhattan,154906693,94011225,0.6068893679113013,60895468,0.39311063208869873,2002
898,Lone Survivor,154802912,125095601,0.8080959161801814,29707311,0.19190408381981858,2013
899,The Phantom of the Opera,154648887,51268815,0.331517516837997,103380072,0.668482483162003,2004
900,Yesterday,154608507,73286650,0.47401434385496005,81321857,0.5259856561450399,2019
901,Ride Along,154468902,134938200,0.8735622397315933,19530702,0.12643776026840664,2014
902,Kill Bill: Vol. 2,154116796,66208183,0.4295974528305143,87908613,0.5704025471694857,2004
903,The Town,154026136,92186262,0.598510515124524,61839874,0.4014894848754759,2010
904,Peter Rabbit 2: The Runaway,153736536,40336536,0.2623744299793512,113400000,0.7376255700206489,2021
905,Sweeney Todd: The Demon Barber of Fleet Street,153383627,52898073,0.34487431308427724,100485554,0.6551256869157227,2007
906,Monkey King: Hero Is Back,153262397,0,0.0,153262397,1.0,2015
907,Tower Heist,152930623,78046570,0.5103397113604906,74884053,0.48966028863950944,2011
908,Duckweed,152894264,471575,0.0030843210704098096,152422689,0.9969156789295902,2017
909,Chocolat,152699946,71509363,0.4682998578139641,81190583,0.5317001421860359,2000
910,Date Night,152263880,98711404,0.6482916631311378,53552476,0.35170833686886216,2010
911,Vantage Point,152039882,72266306,0.4753115106995413,79773576,0.5246884893004586,2008
912,Surf's Up,152005713,58867694,0.3872729046703659,93138019,0.6127270953296341,2007
913,Bad Grandpa,151826547,102003019,0.6718391547164674,49823528,0.3281608452835327,2013
914,47 Ronin,151783839,38362475,0.25274413437388416,113421364,0.7472558656261158,2013
915,Midnight in Paris,151670143,56817045,0.3746092927465625,94853098,0.6253907072534375,2011
916,Red Sparrow,151572634,46874505,0.30925440670246584,104698129,0.6907455932975342,2018
917,Darkest Hour,150847207,56468410,0.37434176689794463,94378797,0.6256582331020554,2017
918,Step Up 2: The Streets,150816700,58017783,0.3846907073288303,92798917,0.6153092926711697,2008
919,Gods of Egypt,150680864,31153464,0.20675129656808977,119527400,0.7932487034319102,2015
920,The Taking of Pelham 123,150166126,65452312,0.4358660221413716,84713814,0.5641339778586284,2009
921,A Writer's Odyssey,150123320,160013,0.001065877040289277,149963307,0.9989341229597107,2021
922,I Am Number Four,149878437,55100437,0.36763418476268206,94778000,0.6323658152373179,2011
923,Jack and Jill,149673788,74158157,0.49546522467915355,75515631,0.5045347753208465,2011
924,Friends with Benefits,149542245,55802754,0.37315712359407205,93739491,0.626842876405928,2011
925,Beverly Hills Chihuahua,149292488,94514402,0.633082101224008,54778086,0.366917898775992,2008
926,"Me, Myself & Irene",149270999,90570999,0.606755495754403,58700000,0.393244504245597,2000
927,No Strings Attached,149228077,70662220,0.473518264260686,78565857,0.526481735739314,2011
928,Charlotte's Web,148963822,82985708,0.5570863239532079,65978114,0.4429136760467921,2006
929,Lights Out,148868835,67268835,0.4518664702387172,81600000,0.5481335297612828,2016
930,The Secret World of Arrietty,148800274,19202743,0.12905045457107156,129597531,0.8709495454289284,2010
931,King Arthur: Legend of the Sword,148675066,39175066,0.2634945257061463,109500000,0.7365054742938537,2017
932,Seabiscuit,148336445,120277854,0.8108449275564074,28058591,0.18915507244359267,2003
933,RED 2,148075565,53262560,0.35969850933879605,94813005,0.640301490661204,2013
934,Spy Kids,147934180,112719001,0.7619537351002993,35215179,0.23804626489970065,2001
935,The Game Plan,147880543,90648202,0.6129826152991608,57232341,0.38701738470083924,2007
936,The Mexican,147845033,66845033,0.4521290410885836,81000000,0.5478709589114164,2001
937,The Angry Birds Movie 2,147792047,41667116,0.2819307049722371,106124931,0.7180692950277628,2019
938,Saw II,147748505,87039965,0.5891089388687892,60708540,0.41089106113121077,2005
939,Resident Evil: Extinction,147717833,50648679,0.3428745058831184,97069154,0.6571254941168816,2007
940,Arthur Christmas,147419472,46462469,0.31517185870805453,100957003,0.6848281412919455,2011
941,Source Code,147332697,54712227,0.3713515608826464,92620470,0.6286484391173536,2011
942,Swordfish,147080413,69772969,0.4743865452703073,77307444,0.5256134547296927,2001
943,Planes: Fire & Rescue,146965787,59165787,0.402582044486313,87800000,0.597417955513687,2014
944,The Last Witch Hunter,146936910,27367660,0.18625449521158435,119569250,0.8137455047884157,2015
945,Angel Has Fallen,146661977,69030436,0.470677113537069,77631541,0.529322886462931,2019
946,Mama,146428180,71628180,0.4891693661698179,74800000,0.5108306338301821,2013
947,Music and Lyrics,145896422,50572589,0.3466335109986453,95323833,0.6533664890013546,2007
948,Time Raiders,145819137,0,0.0,145819137,1.0,2016
949,Blades of Glory,145710347,118594548,0.8139061531436749,27115799,0.18609384685632518,2007
950,The Foreigner,145374099,34393507,0.23658620921186244,110980592,0.7634137907881375,2017
951,Home on the Range,145358062,50030461,0.344187727268956,95327601,0.655812272731044,2004
952,The Exorcism of Emily Rose,145166804,75072454,0.5171461514024929,70094350,0.4828538485975072,2005
953,"Crazy, Stupid, Love.",145051197,84351197,0.5815270659227997,60700000,0.4184729340772003,2011
954,Herbie Fully Loaded,144146816,66023816,0.4580317334237893,78123000,0.5419682665762108,2005
955,The Beach,144056873,39785027,0.2761758336931276,104271846,0.7238241663068724,2000
956,Pete's Dragon,143695338,76233151,0.5305193060612725,67462187,0.4694806939387275,2016
957,Garfield: A Tail of Two Kitties,143325970,28426747,0.19833633081290153,114899223,0.8016636691870985,2006
958,The Invisible Man,143151000,70410000,0.49185824758471824,72741000,0.5081417524152818,2020
959,Spy Game,143049560,62362560,0.435950729243767,80687000,0.564049270756233,2001
960,More Than Blue,142958164,722669,0.005055108290282743,142235495,0.9949448917097172,2018
961,Paranormal Activity 4,142802657,53885000,0.3773389174404507,88917657,0.6226610825595493,2012
962,The Legend of Zorro,142400065,46464023,0.32629214740878104,95936042,0.673707852591219,2005
963,Power Rangers,142337240,85364450,0.5997337731151735,56972790,0.4002662268848265,2017
964,New Year's Eve,142044638,54544638,0.3839964589159641,87500000,0.6160035410840359,2011
965,Onward,141933996,61555145,0.433688522374865,80378851,0.566311477625135,2020
966,Monster House,141861243,73661010,0.519246895362393,68200233,0.48075310463760706,2006
967,Legally Blonde,141774679,96520674,0.6808033330126602,45254005,0.31919666698733984,2001
968,The Taking of Tiger Mountain,141654055,228984,0.0016165015537324364,141425071,0.9983834984462676,2014
969,Gothika,141591324,59694580,0.42159772444814486,81896744,0.5784022755518552,2003
970,Big Momma's House 2,141522961,70165972,0.495792142166952,71356989,0.504207857833048,2006
971,Mona Lisa Smile,141337989,63860942,0.4518314039405216,77477047,0.5481685960594784,2003
972,Scary Movie 2,141220678,71308997,0.5049472783298774,69911681,0.49505272167012254,2001
973,Shallow Hal,141069860,70839203,0.5021568958812321,70230657,0.4978431041187678,2001
974,Trainwreck,140795793,110212700,0.7827840424180856,30583093,0.2172159575819144,2015
975,Sausage Party,140705322,97685686,0.6942572221966131,43019636,0.3057427778033869,2016
976,Girls Trip,140552359,115171585,0.8194212165446473,25380774,0.18057878345535275,2017
977,Step Up Revolution,140470746,35074677,0.24969381881121355,105396069,0.7503061811887864,2012
978,Lion,140312928,51738905,0.3687394008341127,88574023,0.6312605991658873,2016
979,The SpongeBob SquarePants Movie,140192993,85417988,0.6092885683666087,54775005,0.3907114316333913,2004
980,Legend of the Guardians: The Owls of Ga'Hoole,140073390,55675313,0.3974724464082721,84398077,0.6025275535917278,2010
981,The Wolfman,139789765,61979680,0.4433778109577622,77810085,0.5566221890422378,2010
982,Saw IV,139352633,63300095,0.4542439826020367,76052538,0.5457560173979633,2007
983,Mr. Six,139191345,1415450,0.010169094924688026,137775895,0.989830905075312,2015
984,Brüno,138805831,60054530,0.4326513487751102,78751301,0.5673486512248899,2009
985,The Admiral: Roaring Currents,138342258,2589811,0.018720317547513212,135752447,0.9812796824524868,2014
986,America's Sweethearts,138307673,93607673,0.676807518842429,44700000,0.32319248115757104,2001
987,Let's Be Cops,138224951,82390774,0.5960629640592168,55834177,0.40393703594078323,2014
988,Bridge to Terabithia,137587063,82272442,0.5979664090947272,55314621,0.40203359090527285,2007
989,Stardust,137515140,38634938,0.28095043207606085,98880202,0.7190495679239391,2007
990,Escape Plan,137328301,25135965,0.18303557836923942,112192336,0.8169644216307606,2013
991,The First Purge,137056262,69488745,0.5070089026650968,67567517,0.49299109733490326,2018
992,Annie,136853506,85911262,0.6277607677804031,50942244,0.3722392322195969,2014
993,The Best Exotic Marigold Hotel,136836156,46412041,0.3391796609662142,90424115,0.6608203390337858,2012
994,How Long Will I Love U,136796719,746933,0.005460167505918033,136049786,0.994539832494082,2018
995,Remember the Titans,136706683,115654751,0.8460065628247304,21051932,0.15399343717526962,2000
996,Skiptrace,136579287,0,0.0,136579287,1.0,2016
997,Contagion,136515867,75658097,0.5542073508568788,60857770,0.4457926491431212,2011
998,The Wind Rises,136454220,5209580,0.03817822563494189,131244640,0.9618217743650581,2012
999,The Bounty Hunter,136333522,67061228,0.49189096721201114,69272294,0.5081090327879888,2010
1000,17 Again,136316880,64167069,0.4707199064415207,72149811,0.5292800935584794,2009
1001,Saw: The Final Chapter,136150434,45710178,0.3357328849939619,90440256,0.6642671150060381,2010
1002,Unknown,135710029,63686397,0.4692829076029451,72023632,0.5307170923970549,2011
1003,The Jungle Book 2,135703599,47901582,0.35298682093169836,87802017,0.6470131790683017,2003
1004,Jack Ryan: Shadow Recruit,135503748,50577412,0.3732547087922616,84926336,0.6267452912077384,2014
1005,Babel,135330182,34302837,0.2534751412659742,101027345,0.7465248587340257,2006
1006,Perfume: The Story of a Murderer,135039924,2223293,0.016463968092873038,132816631,0.983536031907127,2006
1007,American Made,134866593,51342000,0.3806873063072039,83524593,0.6193126936927961,2017
1008,Wall Street: Money Never Sleeps,134748021,52474616,0.38942773044510987,82273405,0.6105722695548902,2010
1009,The Princess Diaries 2: Royal Engagement,134734481,95170481,0.7063557917293644,39564000,0.29364420827063564,2004
1010,Last Vegas,134402450,63914167,0.4755431690419334,70488283,0.5244568309580666,2012
1011,The Cat in the Hat,133960541,101149285,0.7550677553623795,32811256,0.24493224463762056,2003
1012,Pokémon the Movie 2000,133949270,43758684,0.32668101886632156,90190586,0.6733189811336785,2000
1013,Point Break,133718711,28782481,0.21524647362178057,104936230,0.7847535263782194,2015
1014,The Big Short,133440870,70259870,0.5265243699325401,63181000,0.47347563006745985,2015
1015,The Artist,133432856,44671682,0.33478772274798646,88761174,0.6652122772520136,2011
1016,1408,132963417,71985628,0.5413942392891422,60977789,0.4586057607108578,2007
1017,Tom and Jerry,132841123,46041123,0.3465878785140954,86800000,0.6534121214859047,2021
1018,Zero Dark Thirty,132820716,95720716,0.7206761029657452,37100000,0.2793238970342548,2012
1019,A Wrinkle in Time,132675864,100478608,0.7573239394921144,32197256,0.2426760605078856,2018
1020,Ghost Rider: Spirit of Vengeance,132563930,51774002,0.39055874399619867,80789928,0.6094412560038014,2012
1021,V for Vendetta,132511035,70511035,0.5321144386201496,62000000,0.4678855613798504,2006
1022,The Three Musketeers,132274484,20374484,0.1540318539439549,111900000,0.8459681460560451,2011
1023,2 Guns,131940411,75612460,0.5730803733815867,56327951,0.4269196266184134,2013
1024,Blade: Trinity,131883935,52411906,0.39740932813386254,79472029,0.6025906718661375,2004
1025,Asterix at the Olympic Games,131856927,0,0.0,131856927,1.0,2008
1026,Save the Last Dance,131706809,91057006,0.6913614162499374,40649803,0.3086385837500626,2001
1027,The House with a Clock in Its Walls,131457147,68549695,0.521460388912898,62907452,0.478539611087102,2018
1028,Bewitched,131426169,63313159,0.4817393634900824,68113010,0.5182606365099176,2005
1029,School of Rock,131095614,81261177,0.6198619047621227,49834437,0.3801380952378773,2003
1030,Atonement,131016624,50927067,0.3887069094376909,80089557,0.6112930905623091,2007
1031,Munich,130982129,47403685,0.36190956248695577,83578444,0.6380904375130443,2005
1032,Man on Fire,130834852,77911774,0.595497092777695,52923078,0.404502907222305,2004
1033,"You, Me and Dupree",130628903,75628110,0.5789538782240252,55000793,0.4210461217759748,2006
1034,A Bad Moms Christmas,130560428,72110659,0.5523163496369665,58449769,0.4476836503630334,2017
1035,About a Boy,130549455,41385278,0.317008431785487,89164177,0.682991568214513,2002
1036,Cloud Atlas,130482868,27108272,0.2077534960375028,103374596,0.7922465039624972,2012
1037,Aliens vs. Predator: Requiem,130290885,41797066,0.32079808192261494,88493819,0.6792019180773851,2007
1038,Raya and the Last Dragon,130281158,54723032,0.4200379612837031,75558126,0.5799620387162969,2021
1039,Failure to Launch,130224158,88715192,0.6812498799185939,41508966,0.3187501200814061,2006
1040,Cheaper by the Dozen 2,130154568,82571173,0.6344085672044949,47583395,0.3655914327955051,2005
1041,Mean Girls,130125829,86058055,0.6613449125461479,44067774,0.3386550874538521,2004
1042,Red Cliff,129708433,627047,0.004834280898297492,129081386,0.9951657191017025,2008
1043,Julie & Julia,129540522,94125426,0.7266099020351331,35415096,0.2733900979648669,2009
1044,Resident Evil: Apocalypse,129342769,51201453,0.3958586428592695,78141316,0.6041413571407305,2004
1045,Warm Hug,129240236,0,0.0,129240236,1.0,2020
1046,The Fighter,129190869,93617009,0.7246410657706777,35573860,0.27535893422932234,2009
1047,The Woman in Black,128955898,54333290,0.4213323379749564,74622608,0.5786676620250436,2012
1048,Space Cowboys,128884132,90464773,0.70190776472002,38419359,0.29809223527998,2000
1049,The Forbidden Kingdom,128779982,52075270,0.4043739499823816,76704712,0.5956260500176184,2008
1050,The Heartbreak Kid,128453183,36787257,0.2863864961602392,91665926,0.7136135038397609,2007
1051,Pan,128388320,35088320,0.2732983810365304,93300000,0.7267016189634695,2015
1052,Space Station 3D,128363881,93383953,0.7274939980974866,34979928,0.2725060019025134,2002
1053,Sister,128317206,0,0.0,128317206,1.0,2021
1054,Step Brothers,128107642,100468793,0.7842529253641246,27638849,0.21574707463587536,2008
1055,Blended,127994610,46294610,0.36169187124364066,81700000,0.6383081287563593,2014
1056,Law Abiding Citizen,127944208,73357727,0.5733571542371031,54586481,0.4266428457628969,2009
1057,The Adjustment Bureau,127869379,62495645,0.4887459803804944,65373734,0.5112540196195057,2010
1058,U-571,127666415,77122415,0.6040932143351875,50544000,0.39590678566481247,2000
1059,Ad Astra,127461872,50188370,0.393752023350167,77273502,0.606247976649833,2019
1060,Midway,127420861,56846802,0.4461341852022174,70574059,0.5538658147977826,2019
1061,March of the Penguins,127392693,77437223,0.60786235989218,49955470,0.39213764010782,2005
1062,Predators,127233108,52000688,0.40870406152461514,75232420,0.5912959384753849,2010
1063,Chronicle,126636097,64575175,0.5099270786906833,62060922,0.49007292130931673,2012
1064,Walking with Dinosaurs 3D,126546518,36076121,0.2850818937586256,90470397,0.7149181062413744,2012
1065,Sex Tape,126069509,38543473,0.30573191968249835,87526036,0.6942680803175016,2014
1066,This Is the End,126041322,101470202,0.8050550437736602,24571120,0.1949449562263398,2013
1067,The Upside,125852517,108252517,0.860153770305603,17600000,0.13984622969439697,2019
1068,Detective Chinatown,125842935,474252,0.003768602504383738,125368683,0.9962313974956163,2015
1069,Wolf Totem,125837070,210591,0.0016735211651065938,125626479,0.9983264788348934,2015
1070,Mechanic: Resurrection,125729635,21218403,0.1687621458536804,104511232,0.8312378541463196,2016
1071,Ender's Game,125544024,61737191,0.49175730578780874,63806833,0.5082426942121913,2013
1072,Happy Death Day,125479266,55683845,0.44376929173302626,69795421,0.5562307082669737,2017
1073,Captain Underpants: The First Epic Movie,125427681,73921000,0.5893515642691345,51506681,0.4106484357308655,2017
1074,Legally Blonde 2,124914842,90186328,0.7219824846754399,34728514,0.2780175153245601,2003
1075,The Family Man,124745083,75793305,0.6075855110056723,48951778,0.39241448899432774,2000
1076,Ride Along 2,124605297,91221830,0.7320862932496361,33383467,0.2679137067503639,2015
1077,Coraline,124596837,75286229,0.6042386854491338,49310608,0.39576131455086616,2009
1078,Ray,123971376,75331600,0.6076531731002163,48639776,0.39234682689978373,2004
1079,The Time Machine,123729176,56832494,0.4593297703687932,66896682,0.5406702296312068,2002
1080,The Theory of Everything,123726688,35893537,0.2901034334645731,87833151,0.7098965665354269,2014
1081,The Queen,123384128,56441711,0.4574470956264326,66942417,0.5425529043735674,2006
1082,Nanny McPhee,123276807,47144110,0.3824248141014879,76132697,0.6175751858985121,2005
1083,Big Fish,123218424,66809693,0.5422053848051165,56408731,0.4577946151948835,2003
1084,Hide and Seek,123204920,51100486,0.41476010860605245,72104434,0.5852398913939476,2005
1085,The Curse of La Llorona,123133739,54733739,0.4445064321485438,68400000,0.5554935678514562,2019
1086,The Lego Ninjago Movie,123081555,59281555,0.4816445079849698,63800000,0.5183554920150302,2017
1087,The Pirates! Band of Misfits,123054041,31051126,0.25233731251458863,92002915,0.7476626874854114,2012
1088,Looking Up,122994583,84267,0.0006851277344466463,122910316,0.9993148722655534,2019
1089,Zombieland: Double Tap,122810399,73123082,0.5954144160056023,49687317,0.40458558399439776,2019
1090,Dragon Blade,122593849,74068,0.0006041738684621934,122519781,0.9993958261315378,2015
1091,Spirit: Stallion of the Cimarron,122563539,73280117,0.5978949171825073,49283422,0.40210508281749274,2002
1092,Surrogates,122444772,38577772,0.3150626308487879,83867000,0.6849373691512121,2009
1093,Invictus,122233971,37491364,0.3067180399465219,84742607,0.6932819600534781,2009
1094,Prisoners,122126687,61002302,0.4995001788593512,61124385,0.5004998211406488,2013
1095,Secret Superstar,122026260,0,0.0,122026260,1.0,2017
1096,Peter Pan,121975011,48462608,0.3973158731668407,73512403,0.6026841268331593,2003
1097,PAW Patrol: The Movie,121819471,40019471,0.32851456890664055,81800000,0.6714854310933595,2021
1098,Deepwater Horizon,121790373,61433527,0.5044202221139433,60356846,0.4955797778860567,2016
1099,Pride & Prejudice,121616555,38405088,0.31578832339067653,83211467,0.6842116766093235,2005
1100,Last Christmas,121550750,35150750,0.2891857927655732,86400000,0.7108142072344268,2019
1101,Soul,120957731,0,0.0,120957731,1.0,2020
1102,The Nut Job,120885527,64251541,0.531507307735855,56633986,0.4684926922641451,2014
1103,Intolerable Cruelty,120801243,35327628,0.2924442424818427,85473615,0.7075557575181574,2003
1104,Apocalypto,120673227,50866635,0.42152378174157884,69806592,0.5784762182584211,2006
1105,Instant Family,120556201,67363237,0.5587704028596588,53192964,0.4412295971403412,2018
1106,Eight Below,120455994,81612565,0.6775301277244866,38843429,0.3224698722755133,2006
1107,Red Cliff II,120432178,0,0.0,120432178,1.0,2009
1108,We Bought a Zoo,120081841,75624550,0.629775071486454,44457291,0.37022492851354605,2011
1109,The Pianist,120072577,32572577,0.27127407284679167,87500000,0.7287259271532084,2002
1110,The Omen,119974972,54607383,0.4551564554647281,65367589,0.544843544535272,2006
1111,The Commuter,119942387,36343858,0.3030109614210029,83598529,0.6969890385789971,2017
1112,Extreme Job,119932733,1565885,0.013056360518358236,118366848,0.9869436394816418,2019
1113,Parental Guidance,119772232,77267296,0.6451186114658028,42504936,0.35488138853419715,2012
1114,Road Trip,119754278,68540777,0.5723451232364325,51213501,0.4276548767635675,2000
1115,Spy Kids 2: Island of Lost Dreams,119723358,85846429,0.7170399363505991,33876929,0.2829600636494008,2002
1116,Dora and the Lost City of Gold,119682635,60477943,0.505319280445321,59204692,0.4946807195546789,2019
1117,Wonder Park,119559110,45216793,0.37819613244026323,74342317,0.6218038675597368,2019
1118,Allied,119520023,40098064,0.33549243878575896,79421959,0.664507561214241,2016
1119,Charlie Wilson's War,119483446,66661095,0.5579107167699198,52822351,0.44208928323008023,2007
1120,Sahara,119240351,68671925,0.5759117985152526,50568426,0.4240882014847474,2005
1121,Unfaithful,119137784,52775765,0.442980918631154,66362019,0.557019081368846,2002
1122,I Belonged to You,119107580,744541,0.006250995948368693,118363039,0.9937490040516314,2016
1123,The Shallows,119100758,55124043,0.46283536667331704,63976715,0.537164633326683,2016
1124,Forever Young,119055731,0,0.0,119055731,1.0,2017
1125,Final Destination 3,118890272,54098051,0.4550250419142787,64792221,0.5449749580857213,2006
1126,Hankyu Railways - A 15-minute Miracle,118799256,0,0.0,118799256,1.0,2011
1127,Lost in Translation,118685453,44585453,0.3756606380396088,74100000,0.6243393619603912,2003
1128,The Purge: Election Year,118587880,79213375,0.6679719293405025,39374505,0.3320280706594974,2016
1129,Jurassic Park 2013 Re-release,118192315,45385935,0.38400072796611184,72806380,0.6159992720338882,2013
1130,A Cool Fish,118153135,551876,0.004670853634141828,117601259,0.9953291463658581,2018
1131,Disturbia,118114220,80209692,0.6790858204879988,37904528,0.3209141795120012,2007
1132,Why Him?,118102725,60323786,0.5107738707976467,57778939,0.4892261292023533,2016
1133,Corpse Bride,118090836,53359111,0.4518480248543587,64731725,0.5481519751456413,2005
1134,P Storm,117991727,326711,0.0027689314183866466,117665016,0.9972310685816134,2019
1135,Saving Mr. Banks,117867984,83301580,0.7067362753909493,34566404,0.29326372460905076,2013
1136,Pompeii,117831631,23219748,0.19705869979852864,94611883,0.8029413002014714,2014
1137,Magic Mike XXL,117813057,66013057,0.5603203811271954,51800000,0.43967961887280455,2015
1138,The Notebook,117812623,81001787,0.6875476068468487,36810836,0.3124523931531513,2004
1139,Game Night,117679066,69179066,0.5878621266419637,48500000,0.41213787335803637,2018
1140,The Forgotten,117592831,67133509,0.5708979742140914,50459322,0.42910202578590867,2004
1141,A Knight's Tale,117487473,56569702,0.4814956059187689,60917771,0.5185043940812311,2001
1142,Hotel for Dogs,117252578,73034460,0.6228814858126189,44218118,0.377118514187381,2009
1143,Paycheck,117248958,53790451,0.4587712498050516,63458507,0.5412287501949484,2003
1144,Dune,117100000,0,0.0,117100000,1.0,2021
1145,Water for Elephants,117094902,58709717,0.5013857648559286,58385185,0.49861423514407144,2011
1146,Warm Bodies,116980662,66380662,0.5674498747493838,50600000,0.4325501252506162,2013
1147,Barnyard,116755080,72637803,0.6221382658467624,44117277,0.3778617341532377,2006
1148,Finding Neverland,116650613,51680613,0.4430376461030685,64970000,0.5569623538969315,2004
1149,Freddy vs. Jason,116632628,82622655,0.7084008687517527,34009973,0.29159913124824727,2003
1150,Abraham Lincoln: Vampire Hunter,116471580,37519139,0.32213127872052566,78952441,0.6778687212794744,2012
1151,The Ugly Truth Slovenian Re-release,116383693,0,0.0,116383693,1.0,2009
1152,Personal Tailor,116126458,375892,0.0032369195312923434,115750566,0.9967630804687077,2013
1153,Body of Lies,115900897,39394666,0.33989957817151323,76506231,0.6601004218284868,2008
1154,The Chronicles of Riddick,115900534,57761012,0.49836709121633554,58139522,0.5016329087836644,2004
1155,The Iron Lady,115890699,30017992,0.25901985456140875,85872707,0.7409801454385913,2011
1156,Dragon Ball Super: Broly,115757940,30712119,0.26531328218176653,85045821,0.7346867178182335,2018
1157,A Nightmare on Elm Street,115694863,63075011,0.5451841971583474,52619852,0.4548158028416525,2010
1158,Detective Conan: The Fist of Blue Sapphire,115570314,0,0.0,115570314,1.0,2019
1159,Closer,115505027,33987757,0.2942534873395597,81517270,0.7057465126604403,2004
1160,Bride Wars,115375850,58715510,0.5089064132571938,56660340,0.49109358674280623,2009
1161,Pitch Perfect,115350426,65001093,0.5635097784554346,50349333,0.4364902215445654,2012
1162,The Gentlemen,115171795,36471795,0.31667297535824634,78700000,0.6833270246417537,2019
1163,The Monkey King 3,115084576,187074,0.0016255349457081026,114897502,0.998374465054292,2018
1164,Snow Dogs,115035090,81172560,0.7056330377104933,33862530,0.2943669622895066,2002
1165,Dear John,114984666,80014842,0.6958740220195969,34969824,0.3041259779804031,2010
1166,So Young,114926694,11186,9.733160861653256e-05,114915508,0.9999026683913834,2013
1167,The Lake House,114830111,52330111,0.455717673215521,62500000,0.5442823267844791,2006
1168,Book of Love,114679097,0,0.0,114679097,1.0,2016
1169,We Were Soldiers,114660784,78122718,0.6813377274657393,36538066,0.3186622725342607,2002
1170,Office Christmas Party,114501299,54767494,0.47831329843690246,59733805,0.5216867015630976,2016
1171,Hope Springs,114281051,63536011,0.5559627816163504,50745040,0.4440372183836496,2012
1172,The Score,114252154,71107711,0.6223752332931947,43144443,0.3776247667068054,2001
1173,Step Up,114194847,65328121,0.5720759098700837,48866726,0.4279240901299163,2006
1174,Seventh Son,114178613,17223265,0.15084493100297164,96955348,0.8491550689970284,2014
1175,My Love,114016434,86252,0.0007564874375916721,113930182,0.9992435125624083,2021
1176,Coyote Ugly,113916474,60786269,0.5336038490798092,53130205,0.4663961509201909,2000
1177,Saw V,113864059,56746769,0.49837296771582684,57117290,0.5016270322841732,2008
1178,Insomnia,113714830,67355513,0.5923195154053346,46359317,0.40768048459466544,2002
1179,Changeling,113398237,35739802,0.31517070234522254,77658435,0.6848292976547775,2008
1180,Rambo,113244290,42754105,0.37753872623511525,70490185,0.6224612737648847,2008
1181,The Dark Tower,113231078,50701325,0.44776863291895885,62529753,0.5522313670810411,2017
1182,Pet Sematary,113118226,54724696,0.4837831880425706,58393530,0.5162168119574294,2019
1183,White Chicks,113086475,70831760,0.6263504101617811,42254715,0.37364958983821894,2004
1184,The Boss Baby: Family Business,113029895,57278895,0.5067588092513047,55751000,0.49324119074869527,2021
1185,Insidious: Chapter 3,112983889,52218558,0.46217702773534375,60765331,0.5378229722646563,2015
1186,Final Destination,112880294,53331147,0.47245754870199047,59549147,0.5275424512980096,2000
1187,Cats & Dogs: The Revenge of Kitty Galore,112483764,43585753,0.3874848373672844,68898011,0.6125151626327155,2010
1188,Tooth Fairy,112462508,60022256,0.5337090295016362,52440252,0.46629097049836377,2010
1189,Boonie Bears: Blast Into the Past,112367881,0,0.0,112367881,1.0,2019
1190,How to Be Single,112343513,46843513,0.4169667811616324,65500000,0.5830332188383677,2016
1191,The Exorcist 2000 Director's Cut,112053066,39671011,0.3540377110252387,72382055,0.6459622889747613,2000
1192,The Purge: Anarchy,111928365,71962800,0.6429362208587609,39965565,0.35706377914123916,2014
1193,"Dad, Where Are We Going?",111870000,0,0.0,111870000,1.0,2014
1194,Get Hard,111711453,90411453,0.809330203591569,21300000,0.19066979640843093,2015
1195,Underworld: Evolution,111476513,62318875,0.5590314347202446,49157638,0.44096856527975536,2006
1196,Fool's Gold,111231041,70231041,0.6313978577257044,41000000,0.36860214227429555,2008
1197,The Call of the Wild,111105497,62342368,0.5611096631879519,48763129,0.4388903368120481,2020
1198,The Dukes of Hazzard,111069515,80270227,0.7227025975579348,30799288,0.27729740244206524,2005
1199,Good Boys,111037232,83140306,0.748760613917321,27896926,0.251239386082679,2019
1200,Mission to Mars,110983407,60883407,0.5485811676334643,50100000,0.4514188323665357,2000
1201,The Santa Clause 3: The Escape Clause,110768122,84500122,0.7628559595873622,26268000,0.23714404041263784,2006
1202,Free Birds,110387072,55750480,0.5050453734292364,54636592,0.49495462657076367,2013
1203,The Kid,110317580,69691949,0.6317392839835682,40625631,0.36826071601643184,2000
1204,10 Cloverfield Lane,110216998,72082998,0.6540098107190326,38134000,0.34599018928096736,2016
1205,Moneyball,110206216,75605492,0.6860365480654921,34600724,0.3139634519345079,2011
1206,Buddies in India,110155128,293194,0.002661646401064506,109861934,0.9973383535989355,2017
1207,Hoodwinked,110013167,51386611,0.46709509780770153,58626556,0.5329049021922985,2005
1208,The 5th Wave,109906372,34916787,0.3176957474312772,74989585,0.6823042525687227,2015
1209,Peter Pan 2: Return to Never Land,109862682,48430258,0.4408253750805028,61432424,0.5591746249194972,2002
1210,Sideways,109706931,71503593,0.6517691484779572,38203338,0.34823085152204286,2004
1211,The Prestige,109676311,53089891,0.4840597802382321,56586420,0.5159402197617678,2006
1212,Treasure Planet,109578115,38176783,0.3483978803614207,71401332,0.6516021196385793,2002
1213,Along With the Gods: The Two Worlds,109383972,1908823,0.017450664526974757,107475149,0.9825493354730253,2017
1214,Billy Elliot,109280263,21995263,0.20127388419627065,87285000,0.7987261158037293,2000
1215,Transporter 3,108979549,31715062,0.2910184735669993,77264487,0.7089815264330007,2008
1216,Earth,108975160,32011576,0.293751126403485,76963584,0.706248873596515,2007
1217,The Reader,108902486,34194407,0.3139910598551442,74708079,0.6860089401448558,2008
1218,The Hours,108846072,41675994,0.382889278723811,67170078,0.617110721276189,2002
1219,Sanctum,108609310,23209310,0.2136954005140075,85400000,0.7863045994859925,2010
1220,Cinderella Man,108539911,61649911,0.5679930122662437,46890000,0.4320069877337563,2005
1221,Confessions of a Shopaholic,108394089,44277350,0.40848491286273,64116739,0.59151508713727,2009
1222,The Boxtrolls,108255770,50837305,0.4696036525351027,57418465,0.5303963474648973,2014
1223,Hidalgo,108040622,67303450,0.6229457842254925,40737172,0.3770542157745075,2004
1224,Asterix & Obelix: Mission Cleopatra,108012365,0,0.0,108012365,1.0,2002
1225,Neighbors 2: Sorority Rising,108007109,55455765,0.5134455084803723,52551344,0.48655449151962765,2016
1226,Arthur and the Invisibles,107944236,15132763,0.14019056098558147,92811473,0.8598094390144185,2006
1227,Horrible Bosses 2,107645357,54445357,0.5057845365313806,53200000,0.49421546346861944,2014
1228,Paul Blart: Mall Cop 2,107588225,71038190,0.6602784830774929,36550035,0.33972151692250707,2015
1229,The Amityville Horror,107516369,65233369,0.6067296506265013,42283000,0.39327034937349864,2005
1230,Vacation,107228221,58884188,0.5491482321617552,48344033,0.45085176783824477,2015
1231,Shaft,107196498,70334258,0.656124587204332,36862240,0.343875412795668,2000
1232,ParaNorman,107139399,56003051,0.5227120137196215,51136348,0.4772879862803785,2012
1233,The Texas Chainsaw Massacre,107071655,80571655,0.7525021911728179,26500000,0.24749780882718214,2003
1234,Harmony,107056263,0,0.0,107056263,1.0,2010
1235,The Man from U.N.C.L.E.,107045109,45445109,0.42454166682197503,61600000,0.575458333178025,2015
1236,The Breakup Guru,106980263,208959,0.00195324814260365,106771304,0.9980467518573963,2014
1237,Hereafter,106956330,32746941,0.30617113545313307,74209389,0.693828864546867,2010
1238,Made of Honor,106407672,46012734,0.43241932780937076,60394938,0.5675806721906292,2008
1239,Race to Witch Mountain,106387141,67172594,0.6313976799132143,39214547,0.3686023200867857,2009
1240,Chronicles of the Ghostly Tribe,106380000,0,0.0,106380000,1.0,2015
1241,The Whole Nine Yards,106371651,57262492,0.5383247459419428,49109159,0.46167525405805726,2000
1242,Shaun the Sheep Movie,106209378,19375982,0.18243193176406702,86833396,0.817568068235933,2015
1243,About Schmidt,105834556,65016287,0.6143200241705554,40818269,0.3856799758294446,2002
1244,Forgetting Sarah Marshall,105833257,63172463,0.5969055927287582,42660794,0.4030944072712418,2008
1245,Life as We Know It,105734416,53374681,0.50479950634049,52359735,0.4952004936595101,2010
1246,First Man,105697415,44936545,0.4251432733714443,60760870,0.5748567266285557,2018
1247,Planet 51,105647102,42194060,0.39938681895883904,63453042,0.600613181041161,2009
1248,The Brothers Grimm,105316267,37916267,0.36002289181024616,67400000,0.6399771081897538,2005
1249,Gangster Squad,105200903,46000903,0.4372671877160598,59200000,0.5627328122839402,2013
1250,Along Came a Spider,105178561,74078174,0.7043086851131192,31100387,0.2956913148868808,2001
1251,Sisters,105011053,87044645,0.8289093625220576,17966408,0.17109063747794245,2015
1252,The Campaign,104907746,86907746,0.8284206773444546,18000000,0.17157932265554537,2012
1253,Training Day,104876233,76631907,0.7306889731632523,28244326,0.2693110268367477,2001
1254,Let the Bullets Fly,104723314,63012,0.0006016998277957476,104660302,0.9993983001722042,2010
1255,Scary Stories to Tell in the Dark,104545505,68947075,0.6594934425922951,35598430,0.3405065574077049,2019
1256,The Hitchhiker's Guide to the Galaxy,104478416,51085416,0.48895664727535687,53393000,0.5110433527246432,2005
1257,Book Club,104438188,68566296,0.6565251400187065,35871892,0.34347485998129346,2018
1258,The Girl with the Dragon Tattoo,104414200,10095170,0.09668388016189369,94319030,0.9033161198381063,2009
1259,The Tuxedo,104391623,50547998,0.4842150792118636,53843625,0.5157849207881364,2002
1260,The Cell,104155843,61334059,0.5888681540410555,42821784,0.4111318459589444,2000
1261,Little Man,104003322,58645052,0.5638767192455642,45358270,0.4361232807544359,2006
1262,The Water Horse,103967384,40946255,0.3938375038848722,63021129,0.6061624961151278,2007
1263,Wrath of Man,103966489,27466489,0.26418598208120697,76500000,0.7358140179187931,2021
1264,The Tales of Wukong,103818506,0,0.0,103818506,1.0,2017
1265,Ouija,103590271,50856010,0.49093423068658637,52734261,0.5090657693134136,2014
1266,The Stepford Wives,103370127,59484742,0.5754538929801257,43885385,0.42454610701987433,2004
1267,Rugrats in Paris,103291131,76507756,0.7407001478181123,26783375,0.2592998521818877,2000
1268,Birdman or (The Unexpected Virtue of Ignorance),103215094,42340598,0.41021711417518064,60874496,0.5897828858248194,2014
1269,Cold War II,103197501,560824,0.00543447268165922,102636677,0.9945655273183408,2016
1270,Guess Who,103121466,68915888,0.6682981795468268,34205578,0.33170182045317315,2005
1271,Night School,103105878,77339130,0.75009428657404,25766748,0.24990571342596005,2018
1272,Saw,103096345,55185045,0.5352764445723076,47911300,0.4647235554276924,2004
1273,Transcendence,103039258,23022309,0.22343240282262125,80016949,0.7765675971773788,2014
1274,Jimmy Neutron: Boy Genius,102992536,80936232,0.7858456072972123,22056304,0.21415439270278772,2001
1275,Resident Evil,102984862,40119709,0.3895689931594024,62865153,0.6104310068405976,2002
1276,Jigsaw,102952888,38052832,0.3696140316141496,64900056,0.6303859683858505,2017
1277,Just Like Heaven,102854431,48318130,0.4697719828910434,54536301,0.5302280171089566,2005
1278,Love & Other Drugs,102820008,32367005,0.31479286599549766,70453003,0.6852071340045023,2010
1279,Chappie,102811889,31569268,0.3070585348354022,71242621,0.6929414651645979,2015
1280,Star Wars: Episode I - The Phantom Menace 2012 3D Release,102739593,43456382,0.4229759991359903,59283211,0.5770240008640096,2012
1281,Project X,102731865,54731865,0.5327642499238187,48000000,0.46723575007618134,2012
1282,Zombieland,102392080,75590286,0.7382434852383114,26801794,0.2617565147616886,2009
1283,Ghosts of Girlfriends Past,102366815,55250026,0.5397259453661815,47116789,0.4602740546338186,2009
1284,The Wild,102338515,37384046,0.36529791349815854,64954469,0.6347020865018415,2006
1285,Dawn of the Dead,102278712,59020957,0.5770600337634287,43257755,0.4229399662365713,2004
1286,John Q,102244770,71756802,0.7018139118509436,30487968,0.29818608814905645,2002
1287,Railroad Tigers,102205175,218044,0.002133394908819441,101987131,0.9978666050911805,2016
1288,Heaven Is for Real,101888019,91443253,0.8974877900020806,10444766,0.10251220999791938,2014
1289,Detective Conan: Zero the Enforcer,101860359,0,0.0,101860359,1.0,2018
1290,The Devil Inside,101758490,53261944,0.5234152354265477,48496546,0.4765847645734523,2012
1291,Pineapple Express,101624843,87341380,0.8594491014367422,14283463,0.1405508985632578,2008
1292,Just Married,101564935,56127162,0.5526234226408947,45437773,0.4473765773591053,2003
1293,Miss Congeniality 2: Armed & Fabulous,101393569,48478006,0.4781171673718281,52915563,0.5218828326281719,2005
1294,The Time Traveler's Wife,101344412,63414846,0.625735990258644,37929566,0.37426400974135604,2009
1295,Hitman,101276318,39687694,0.3918753641892866,61588624,0.6081246358107134,2007
1296,The Recruit,101191884,52802140,0.5218021239727091,48389744,0.47819787602729086,2003
1297,Joy,101134059,56451232,0.5581822044737669,44682827,0.4418177955262332,2015
1298,Little Miss Sunshine,101058954,59891098,0.5926352453638101,41167856,0.4073647546361899,2006
1299,Kung Fu Hustle,100912445,17108591,0.16953896023429024,83803854,0.8304610397657097,2004
1300,My Bloody Valentine,100734718,51545952,0.5116999682274387,49188766,0.48830003177256126,2009
1301,"Alexander and the Terrible, Horrible, No Good, Very Bad Day",100654149,66954149,0.665190155251325,33700000,0.334809844748675,2014
1302,Silent Hill,100605135,46982632,0.46700033750762326,53622503,0.5329996624923767,2006
1303,Ladder 49,100572044,74541707,0.7411772102394578,26030337,0.2588227897605422,2004
1304,Life,100541806,30234022,0.30071095003008,70307784,0.69928904996992,2017
1305,Instructions Not Included,100486616,44467206,0.44251869323572407,56019410,0.557481306764276,2013
1306,Tammy,100375432,84525432,0.8420928340313395,15850000,0.15790716596866053,2014
1307,PK,100370104,10616104,0.10576958254422054,89754000,0.8942304174557795,2014
1308,Aftershock,100293273,62962,0.0006277788940041871,100230311,0.9993722211059958,2010
1309,The Good Shepherd,100266865,59952835,0.5979326769616263,40314030,0.40206732303837367,2006
1310,Where the Wild Things Are,100140096,77233467,0.7712541737527394,22906629,0.22874582624726064,2009
1311,Philomena,100129872,37709979,0.376610678180034,62419893,0.623389321819966,2013
1312,The Continent,100125957,0,0.0,100125957,1.0,2014
1313,Nim's Island,100104565,48006762,0.4795661616430779,52097803,0.520433838356922,2008
1314,Don't Say a Word,100020092,55001642,0.5499059328999617,45018450,0.45009406710003824,2001
1315,Atomic Blonde,100014025,51687870,0.5168062179279356,48326155,0.48319378207206437,2017
1316,The Book of Life,99783556,50151543,0.5026032846534353,49632013,0.4973967153465647,2014
1317,Black Mass,99775678,62575678,0.6271636460340565,37200000,0.3728363539659435,2015
1318,Insidious,99557032,54009150,0.5424945773795266,45547882,0.45750542262047345,2011
1319,Line Walker 2: Invisible Spy,99482027,296751,0.002982960932229497,99185276,0.9970170390677705,2019
1320,The Lucky One,99357138,60457138,0.6084830865397914,38900000,0.39151691346020856,2012
1321,Hellboy,99318987,59623958,0.600327890980201,39695029,0.399672109019799,2004
1322,Shanghai Noon,99274467,56937502,0.5735362145031713,42336965,0.42646378549682873,2000
1323,Nacho Libre,99255460,80197993,0.8079957817937673,19057467,0.19200421820623267,2006
1324,Blue Jasmine,99104804,33405481,0.3370722674553698,65699323,0.6629277325446302,2013
1325,Ode to My Father,99085291,2300121,0.023213546398122804,96785170,0.9767864536018772,2014
1326,Justin Bieber: Never Say Never,99036827,73013910,0.7372399965923787,26022917,0.2627600034076213,2011
1327,Young Detective Dee: Rise of the Sea Dragon,98774891,87783,0.0008887177612780155,98687108,0.999111282238722,2013
1328,Spotlight,98690254,45055776,0.45653723821604514,53634478,0.5434627617839549,2015
1329,Umizaru 3: The Last Message,98663381,0,0.0,98663381,1.0,2010
1330,Devil and Angel,98599942,131058,0.0013291894228497619,98468884,0.9986708105771502,2015
1331,The Visit,98450062,65206105,0.6623267032579421,33243957,0.3376732967420579,2015
1332,Crash,98410061,54580300,0.5546211377716757,43829761,0.4453788622283244,2005
1333,Evolution,98376292,38345494,0.38978389224102894,60030798,0.6102161077589711,2001
1334,Riddick,98337295,42025135,0.4273570368190421,56312160,0.572642963180958,2013
1335,Deep Sea,98230905,46412757,0.47248630153616117,51818148,0.5275136984638389,2006
1336,Alpha,98203196,35857181,0.36513252582940375,62346015,0.6348674741705962,2018
1337,Killers,98159963,47059963,0.4794211566685289,51100000,0.5205788433314711,2010
1338,Once Upon a Time in Mexico,98096026,56359780,0.5745368318997958,41736246,0.4254631681002042,2003
1339,Paul,97984015,37412945,0.3818270255612612,60571070,0.6181729744387388,2011
1340,Along With the Gods: The Last 49 Days,97962238,1200246,0.012252129233715547,96761992,0.9877478707662845,2018
1341,Are We There Yet?,97918663,82674398,0.8443170634386623,15244265,0.15568293656133764,2005
1342,Fred Claus,97838349,72006777,0.7359770247145114,25831572,0.2640229752854885,2007
1343,Phone Booth,97837138,46566212,0.4759564001146477,51270926,0.5240435998853523,2003
1344,I Am Sam,97818139,40311852,0.4121101915463757,57506287,0.5878898084536244,2001
1345,A Simple Favor,97644617,53548586,0.5484028474401206,44096031,0.4515971525598795,2018
1346,Safe Haven,97594140,71349120,0.7310799603336839,26245020,0.26892003966631606,2013
1347,The Little Prince,97571250,1339152,0.013724862600407395,96232098,0.9862751373995926,2015
1348,Evil Dead,97542952,54239856,0.5560612518677925,43303096,0.44393874813220746,2013
1349,42,97470701,95020213,0.9748592348792074,2450488,0.025140765120792555,2013
1350,Scream 4,97138686,38180928,0.39305584183010256,58957758,0.6069441581698974,2011
1351,Jarhead,97076152,62658220,0.6454543027210226,34417932,0.35454569727897745,2005
1352,Legend of the Demon Cat,97051623,0,0.0,97051623,1.0,2017
1353,Enemy at the Gates,96976270,51401758,0.530044700626246,45574512,0.469955299373754,2001
1354,The Shack,96942115,57386418,0.5919658138261168,39555697,0.40803418617388326,2017
1355,Boonie Bears 5,96820519,0,0.0,96820519,1.0,2018
1356,Old Dogs,96753696,49492060,0.5115262986956075,47261636,0.48847370130439255,2009
1357,The Butterfly Effect,96693417,57938693,0.5991999744925759,38754724,0.40080002550742416,2004
1358,Christmas with the Kranks,96572480,73780539,0.7639913461888935,22791941,0.23600865381110644,2004
1359,The Rite,96560591,33047633,0.34224762563849676,63512958,0.6577523743615032,2011
1360,13 Going on 30,96455697,57231747,0.5933475033620875,39223950,0.4066524966379124,2004
1361,Vicky Cristina Barcelona,96409300,23216709,0.24081399823461014,73192591,0.7591860017653899,2008
1362,Contraband,96262212,66528000,0.6911123131057907,29734212,0.3088876868942093,2012
1363,Red Eye,96258201,57891803,0.6014220336405415,38366398,0.3985779663594586,2005
1364,Kick-Ass,96188903,48071303,0.4997593433413,48117600,0.5002406566587,2010
1365,The Tigger Movie,96159800,45554533,0.4737378093548448,50605267,0.5262621906451552,2000
1366,Assassination,96119773,1904682,0.019815714712518098,94215091,0.9801842852874819,2015
1367,The Manchurian Candidate,96105910,65955630,0.6862806876288877,30150280,0.3137193123711122,2004
1368,The 6th Day,96085477,34604280,0.36014058607420973,61481197,0.6398594139257903,2000
1369,Think Like a Man,96070507,91547205,0.9529168509540602,4523302,0.04708314904593977,2012
1370,Dolphin Tale,95932565,72286779,0.7535165874069978,23645786,0.2464834125930022,2011
1371,The Favourite,95918706,34366783,0.35829072798375744,61551923,0.6417092720162426,2018
1372,Teenage Mutant Ninja Turtles IV: Immortal,95797812,54149098,0.5652435777969542,41648714,0.4347564222030457,2007
1373,Be Cool,95763716,56046979,0.5852632013569733,39716737,0.41473679864302676,2005
1374,Qing sheng,95721752,100026,0.0010449662475881135,95621726,0.9989550337524119,2016
1375,My Sister's Keeper,95714875,49200230,0.5140290890000118,46514645,0.48597091099998824,2009
1376,Underworld,95708457,51970690,0.5430104259229673,43737767,0.4569895740770327,2003
1377,Shooter,95696996,47003582,0.49117092452933425,48693414,0.5088290754706658,2007
1378,Detective Conan: The Scarlet Bullet,95659979,0,0.0,95659979,1.0,2021
1379,The New King of Comedy,95618308,0,0.0,95618308,1.0,2019
1380,Poltergeist,95437994,47425125,0.49692080703205055,48012869,0.5030791929679495,2015
1381,The Mortal Instruments: City of Bones,95396573,31165421,0.32669329746258285,64231152,0.6733067025374172,2013
1382,Truth or Dare,95330493,41411015,0.43439421843753606,53919478,0.565605781562464,2018
1383,Rush,95224595,26947624,0.28299016656358583,68276971,0.7170098334364142,2013
1384,40 Days and 40 Nights,95146283,37950822,0.3988681512655623,57195461,0.6011318487344377,2002
1385,The Hustle,95017038,35417038,0.3727440756467277,59600000,0.6272559243532723,2019
1386,Adoring,94975692,0,0.0,94975692,1.0,2019
1387,The Guardian,94973540,55011732,0.5792321945670341,39961808,0.4207678054329659,2006
1388,Changing Lanes,94935764,66818548,0.7038290438153528,28117216,0.2961709561846471,2002
1389,Green Zone,94882549,35053660,0.36944264640276475,59828889,0.6305573535972353,2009
1390,Kill Mobile,94870905,0,0.0,94870905,1.0,2018
1391,The Wedding Planner,94728529,60400856,0.6376205419594344,34327673,0.3623794580405656,2001
1392,I Feel Pretty,94539426,48795601,0.5161402291568811,45743825,0.48385977084311893,2018
1393,Veteran,94393020,1200627,0.01271944684045494,93192393,0.9872805531595451,2015
1394,Masquerade,94268432,922921,0.009790350602203715,93345511,0.9902096493977963,2012
1395,Police Story: Lockdown,94249025,0,0.0,94249025,1.0,2013
1396,Fleet of Time,94244191,569280,0.006040478399353017,93674911,0.9939595216006469,2014
1397,Dirty Grandpa,94073028,35593113,0.378356195784407,58479915,0.6216438042155931,2016
1398,Ben-Hur,94061311,26410477,0.2807793844166174,67650834,0.7192206155833827,2016
1399,Blockers,94017294,60311495,0.6414936277574634,33705799,0.35850637224253656,2018
1400,The Skeleton Key,93983911,47907715,0.5097437900833899,46076196,0.49025620991661006,2005
1401,Syriana,93974620,50824620,0.540833471845909,43150000,0.459166528154091,2005
1402,Speed Racer,93945766,43945766,0.46777803695804665,50000000,0.5322219630419533,2008
1403,In the Heart of the Sea,93920758,25020758,0.26640285420183685,68900000,0.7335971457981632,2015
1404,The Man from Macau,93864936,0,0.0,93864936,1.0,2014
1405,Nothing to Declare,93811164,0,0.0,93811164,1.0,2011
1406,Kill Zone 2,93638358,11998,0.00012813125151126635,93626360,0.9998718687484888,2015
1407,The Lovely Bones,93621340,44114232,0.47119846821248235,49507108,0.5288015317875177,2009
1408,The Internship,93492844,44672764,0.4778201420421011,48820080,0.5221798579578989,2013
1409,BlacKkKlansman,93400823,49275340,0.5275685847008008,44125483,0.47243141529919924,2018
1410,Calendar Girls,93400759,31041759,0.3323501792956522,62359000,0.6676498207043479,2003
1411,Goosebumps 2: Haunted Halloween,93320380,46700633,0.5004333780038187,46619747,0.49956662199618135,2018
1412,Money Monster,93282604,41012075,0.43965405382551287,52270529,0.5603459461744872,2016
1413,Nanny McPhee Returns,93251121,29011215,0.3111084852266816,64239906,0.6888915147733183,2010
1414,Michael Clayton,92991835,49033882,0.5272923370100181,43957953,0.47270766298998185,2007
1415,Secret Window,92913171,48022900,0.5168578306298469,44890271,0.48314216937015314,2004
1416,The Family Stone,92884429,60062868,0.646640870236711,32821561,0.353359129763289,2005
1417,House of Flying Daggers,92863945,11050094,0.11899229566437222,81813851,0.8810077043356278,2004
1418,Train to Busan,92742323,2129768,0.022964359001445327,90612555,0.9770356409985547,2016
1419,Role Models,92649419,67294270,0.7263323475347427,25355149,0.2736676524652572,2008
1420,No Reservations,92601050,43107979,0.4655236522696017,49493071,0.5344763477303983,2007
1421,Four Brothers,92374674,74494381,0.806437281716415,17880293,0.19356271828358496,2005
1422,Evangelion: 3.0+1.01 Thrice Upon a Time,92246218,0,0.0,92246218,1.0,2021
1423,Downfall,92181574,5509040,0.059762919648128375,86672534,0.9402370803518716,2004
1424,Underworld: Rise of the Lycans,92158961,45802315,0.4969925279431047,46356646,0.5030074720568952,2009
1425,Fracture,92011561,39015018,0.42402299858818826,52996543,0.5759770014118117,2007
1426,"I Love You, Man",91980359,71440011,0.7766876730715957,20540348,0.22331232692840436,2009
1427,Southpaw,91970827,52421953,0.5699845778270538,39548874,0.4300154221729462,2015
1428,Brave Hearts: Umizaru,91884352,0,0.0,91884352,1.0,2012
1429,End Game,91815762,23149,0.0002521244663851943,91792613,0.9997478755336148,2021
1430,Behind Enemy Lines,91753202,58856790,0.6414685124558378,32896412,0.3585314875441622,2001
1431,Get Him to the Greek,91720255,60974475,0.6647874561622185,30745780,0.33521254383778154,2010
1432,Shadow,91708374,521396,0.005685369582498541,91186978,0.9943146304175015,2018
1433,Season of the Witch,91627228,24827228,0.2709590647007241,66800000,0.7290409352992759,2011
1434,Crawl,91542097,39014193,0.4261885436161682,52527904,0.5738114563838318,2019
1435,Five Feet Apart,91522094,45729221,0.49965225883052894,45792873,0.500347741169471,2019
1436,Friday the 13th,91509154,65002019,0.7103335148306583,26507135,0.2896664851693416,2009
1437,Rambo: Last Blood,91490353,44819352,0.4898806325514997,46671001,0.5101193674485003,2019
1438,Overboard,91244913,50316123,0.551440308787406,40928790,0.448559691212594,2018
1439,White Noise,91196419,56386759,0.6183001440001717,34809660,0.38169985599982825,2005
1440,Romeo Must Die,91036760,55973336,0.6148432347548397,35063424,0.3851567652451603,2000
1441,Final Destination 2,90941129,46961214,0.5163913678705264,43979915,0.4836086321294736,2003
1442,Paranormal Activity: The Marked Ones,90894962,32462372,0.35714159823291414,58432590,0.6428584017670859,2014
1443,Fantasia 2000,90874570,60655420,0.667463075753756,30219150,0.33253692424624404,2000
1444,Drag Me to Hell,90842646,42100625,0.4634456046117371,48742021,0.5365543953882629,2009
1445,Racing Stripes,90754475,49772522,0.5484304988817356,40981953,0.45156950111826444,2005
1446,Autumn in New York,90726668,37761915,0.4162162662030088,52964753,0.5837837337969912,2000
1447,Anchorman: The Legend of Ron Burgundy,90649730,85288303,0.9408555657032845,5361427,0.0591444342967155,2004
1448,My Big Fat Greek Wedding 2,90632641,59689605,0.6585883887020351,30943036,0.34141161129796493,2016
1449,"My Country, My Parents",90600000,0,0.0,90600000,1.0,2021
1450,Madea Goes to Jail,90508336,90508336,1.0,0,0.0,2009
1451,Sherlock Gnomes,90497778,43242871,0.4778335110062039,47254907,0.522166488993796,2018
1452,Bring It on,90449929,68379000,0.7559873264245459,22070929,0.24401267357545411,2000
1453,Bedazzled,90383208,37886980,0.4191816249761792,52496228,0.5808183750238208,2000
1454,Jojo Rabbit,90335025,33370906,0.369412705647671,56964119,0.630587294352329,2019
1455,Red Riding Hood,90260376,37662162,0.4172613019028416,52598214,0.5827386980971584,2011
1456,Identity,90259536,52159536,0.5778839368285695,38100000,0.42211606317143047,2003
1457,Old,90100320,48230320,0.5352957680949413,41870000,0.4647042319050587,2021
1458,Detective Dee: The Four Heavenly Kings,90040771,262963,0.0029204880975530517,89777808,0.9970795119024469,2018
1459,Sucker Punch,89792502,36392502,0.4052955557469598,53400000,0.5947044442530401,2011
1460,Burlesque,89519773,39440655,0.4405803732321797,50079118,0.5594196267678203,2010
1461,The Hundred-Foot Journey,89514453,54240821,0.6059448411085079,35273632,0.39405515889149206,2014
1462,The Host,89431890,2201923,0.024621228512558553,87229967,0.9753787714874415,2006
1463,The Purge,89328627,64473115,0.7217519978226017,24855512,0.2782480021773983,2013
1464,The Last Song,89137047,62950384,0.7062202094265025,26186663,0.29377979057349746,2010
1465,Transporter 2,89083229,43095856,0.4837706994208753,45987373,0.5162293005791248,2005
1466,Rumor Has It...,88933562,43000262,0.4835099486963088,45933300,0.5164900513036912,2005
1467,Kangaroo Jack,88929111,66934963,0.7526777480098727,21994148,0.24732225199012728,2003
1468,The Inbetweeners,88823111,36000,0.00040529992244923735,88787111,0.9995947000775508,2011
1469,Collateral Beauty,88528280,31016021,0.350351559976089,57512259,0.649648440023911,2016
1470,Shanghai Knights,88323487,60476872,0.6847201582971922,27846615,0.31527984170280776,2003
1471,Line Walker,88228755,0,0.0,88228755,1.0,2016
1472,This Is 40,88215156,67544505,0.7656791424820469,20670651,0.23432085751795304,2012
1473,Rookies the Movie: Graduation,88055243,0,0.0,88055243,1.0,2009
1474,Dhoom 3,88031955,8031955,0.09123908471645324,80000000,0.9087609152835467,2013
1475,Chasing the Dragon,87965942,456854,0.005193532742478902,87509088,0.9948064672575211,2017
1476,Deliver Us from Evil,87937815,30577122,0.3477130060600209,57360693,0.652286993939979,2014
1477,The Illusionist,87892388,39868642,0.45360745005585695,48023746,0.5463925499441431,2006
1478,State of Play,87812371,37017955,0.42155740220247556,50794416,0.5784425977975245,2009
1479,Gosford Park,87754044,41308615,0.47073175339930773,46445429,0.5292682466006923,2001
1480,Ali,87713825,58203105,0.6635567996265127,29510720,0.3364432003734873,2001
1481,RV,87528173,71726025,0.819462151917646,15802148,0.180537848082354,2006
1482,Tiger Zinda Hai,87320000,5560921,0.06368439074667888,81759079,0.9363156092533211,2017
1483,Pain & Gain,87305549,49875291,0.5712728637672274,37430258,0.42872713623277253,2013
1484,Sultan,87280000,6200000,0.07103574702108158,81080000,0.9289642529789184,2016
1485,Epic Movie,87238158,39739367,0.4555273507723535,47498791,0.5444726492276465,2007
1486,A Million Ways to Die in the West,87189756,43139300,0.49477486781818725,44050456,0.5052251321818128,2014
1487,Old School,87135520,75585093,0.8674429555249111,11550427,0.13255704447508893,2003
1488,The Shaggy Dog,87134280,61123569,0.701487049643378,26010711,0.298512950356622,2006
1489,The Thieves,87126367,685839,0.007871773191231536,86440528,0.9921282268087684,2012
1490,About Time,87100449,15322921,0.17592241114623874,71777528,0.8240775888537613,2013
1491,American Dreams in China,87097067,0,0.0,87097067,1.0,2013
1492,Max Payne,87066930,40689393,0.46733464703533245,46377537,0.5326653529646675,2008
1493,The Kingdom,87019158,47536778,0.5462794526235246,39482380,0.45372054737647544,2007
1494,The Tale of Despereaux,86957280,50877145,0.5850820655843881,36080135,0.4149179344156119,2008
1495,"Hello, Mrs. Money",86874070,0,0.0,86874070,1.0,2018
1496,Dinner for Schmucks,86855739,73026337,0.8407773376955552,13829402,0.15922266230444485,2010
1497,Snowpiercer,86758912,4563650,0.052601512568530136,82195262,0.9473984874314698,2013
1498,The Lincoln Lawyer,86752352,58009200,0.6686758187259292,28743152,0.3313241812740708,2011
1499,Robin Hood,86489031,30824628,0.35639927564918605,55664403,0.643600724350814,2018
1500,Tears of the Sun,86468162,43734876,0.5057916693082941,42733286,0.49420833069170594,2003
1501,Sky High,86369815,63946815,0.7403838366447815,22423000,0.2596161633552185,2005
1502,La Vie En Rose,86274793,10301706,0.11940574577791221,75973087,0.8805942542220878,2007
1503,A Taxi Driver,86252940,1527829,0.01771335562590678,84725111,0.9822866443740932,2017
1504,War Dogs,86234523,43034523,0.4990405408747956,43200000,0.5009594591252045,2016
1505,Step Up All in,86165646,14904384,0.1729736233858213,71261262,0.8270263766141787,2014
1506,Hall Pass,86157237,45060734,0.523005792305062,41096503,0.47699420769493805,2011
1507,I Can Only Imagine,86086881,83482352,0.9697453436604353,2604529,0.030254656339564676,2018
1508,John Wick,86013056,43037835,0.5003639796265348,42975221,0.49963602037346516,2014
1509,The Second Best Exotic Marigold Hotel,85978266,33078266,0.38472822887588826,52900000,0.6152717711241118,2015
1510,Meet the Spartans,85897593,38233676,0.4451076527837049,47663917,0.5548923472162951,2008
1511,Date Movie,85749034,48548426,0.5661687803969897,37200608,0.43383121960301035,2006
1512,Match Point,85638656,23151529,0.2703397050042448,62487127,0.7296602949957552,2005
1513,Volver,85585177,12899867,0.15072548135292166,72685310,0.8492745186470784,2006
1514,Spy Kids 4-D: All the Time in the World,85564310,38538188,0.45040026618574963,47026122,0.5495997338142503,2011
1515,Paper Towns,85512300,32000304,0.37421872642882953,53511996,0.6257812735711704,2015
1516,Rat Race,85498534,56618055,0.6622108280827365,28880479,0.33778917191726354,2001
1517,The Possession,85446075,49130154,0.5749843278348362,36315921,0.42501567216516384,2012
1518,Big Fish & Begonia,85409373,0,0.0,85409373,1.0,2016
1519,Bayside Shakedown 3: Set the Guys Loose,85347374,0,0.0,85347374,1.0,2010
1520,Did You Hear About the Morgans?,85280250,29580087,0.34685741423131383,55700163,0.6531425857686862,2009
1521,Nerve,85251425,38583626,0.4525862881470896,46667799,0.5474137118529103,2016
1522,Hidden Man,85170581,0,0.0,85170581,1.0,2018
1523,Final Fantasy: The Spirits Within,85131830,32131830,0.3774361481481133,53000000,0.6225638518518867,2001
1524,J. Edgar,84920539,37306030,0.4393051485459837,47614509,0.5606948514540163,2011
1525,Going in Style,84918541,45018541,0.5301379471416025,39900000,0.46986205285839755,2017
1526,Sicario,84872444,46889293,0.5524678068655593,37983151,0.44753219313444065,2015
1527,Carrie,84790678,35266619,0.41592566343201076,49524059,0.5840743365679892,2013
1528,Zodiac,84785914,33080084,0.39016013910046426,51705830,0.6098398608995358,2007
1529,The Animal,84772742,57743062,0.6811512832745223,27029680,0.31884871672547765,2001
1530,Jackass Number Two,84645164,72778712,0.8598094511341486,11866452,0.14019054886585133,2006
1531,The Judge,84419388,47119388,0.5581583699706517,37300000,0.44184163002934823,2014
1532,What to Expect When You're Expecting,84384002,41152203,0.4876777828100639,43231799,0.5123222171899361,2012
1533,Nights in Rodanthe,84375346,41850659,0.4960057763792755,42524687,0.5039942236207244,2008
1534,Leap!,84197417,2844490,0.0337835779451524,81352927,0.9662164220548476,2016
1535,French Fried Vacation 3: Friends Forever,84152064,0,0.0,84152064,1.0,2006
1536,Premonition,84146832,47852604,0.5686798048439898,36294228,0.43132019515601017,2007
1537,Finding Mr. Right,84112033,6945,8.256844772733052e-05,84105088,0.9999174315522726,2013
1538,Our Times,83867493,0,0.0,83867493,1.0,2015
1539,Pan's Labyrinth,83850267,37634615,0.4488311885757024,46215652,0.5511688114242975,2006
1540,Marmaduke,83761844,33644788,0.40167200712534457,50117056,0.5983279928746554,2010
1541,In Her Shoes,83697473,32880591,0.3928504627612831,50816882,0.6071495372387169,2005
1542,Mortal Engines,83672673,15951040,0.19063619492591088,67721633,0.8093638050740891,2018
1543,Mortal Kombat,83601013,42201013,0.5047906895577928,41400000,0.49520931044220723,2021
1544,Snatch,83557872,30328156,0.3629598896439105,53229716,0.6370401103560895,2000
1545,Blow,83282296,52990775,0.6362789877935162,30291521,0.36372101220648384,2001
1546,Piranha 3D,83188165,25003155,0.30056144404675833,58185010,0.6994385559532417,2010
1547,Oceans,83090556,19422319,0.23374881496761196,63668237,0.766251185032388,2010
1548,Rings,83080890,27793018,0.33452961324800445,55287872,0.6654703867519955,2017
1549,Suck Me Shakespeer 2,83027924,0,0.0,83027924,1.0,2015
1550,Savages,82966152,47382068,0.5711011883496778,35584084,0.4288988116503222,2012
1551,Once Upon A Time,82886178,485728,0.005860180933906736,82400450,0.9941398190660933,2017
1552,The Fighter Pilot,82879386,0,0.0,82879386,1.0,2013
1553,Firewall,82751189,48751189,0.5891297706912707,34000000,0.41087022930872935,2006
1554,28 Days Later...,82719885,45064915,0.5447893816583521,37654970,0.45521061834164783,2002
1555,"Big Mommas: Like Father, Like Son",82686066,37915414,0.4585465947793429,44770652,0.5414534052206571,2011
1556,Sinister,82515113,48086903,0.5827647960683275,34428210,0.4172352039316725,2012
1557,Act of Valor,82497035,70012847,0.8486710704208945,12484188,0.1513289295791055,2012
1558,The Constant Gardener,82466670,33579797,0.4071923481328881,48886873,0.5928076518671119,2005
1559,The Strangers,82410456,52597610,0.6382395214510159,29812846,0.36176047854898413,2008
1560,Hitman: Agent 47,82347656,22467450,0.2728365455842483,59880206,0.7271634544157517,2015
1561,Men of Honor,82343495,48818921,0.5928691877846575,33524574,0.4071308122153426,2000
1562,Tiny Times 3.0,82320000,0,0.0,82320000,1.0,2014
1563,Blades of Blood 2010 Re-release,82177196,0,0.0,82177196,1.0,2010
1564,Hannibal Rising,82169884,27670986,0.33675337791641524,54498898,0.6632466220835848,2007
1565,Reign of Fire,82150183,43061982,0.5241860751545739,39088201,0.4758139248454261,2002
1566,Catwoman,82102379,40202379,0.48966156023323026,41900000,0.5103384397667697,2004
1567,Miracle in Cell No. 7,82101723,0,0.0,82101723,1.0,2013
1568,Abduction,82087155,28087155,0.34216260753585626,54000000,0.6578373924641437,2011
1569,The Chorus,82032134,2087128,0.025442810009063035,79945006,0.974557189990937,2004
1570,Hostel,81979826,47326473,0.5772941381944382,34653353,0.4227058618055618,2006
1571,Rabbit Without Ears,81744033,0,0.0,81744033,1.0,2007
1572,Ouija: Origin of Evil,81705746,35144505,0.43013504827432825,46561241,0.5698649517256718,2016
1573,One Piece: Stampede,81562741,1298528,0.01592060276640286,80264213,0.9840793972335972,2019
1574,Frankenweenie,81491068,35291068,0.43306670124877983,46200000,0.5669332987512202,2012
1575,Wolf Warrior,81411331,0,0.0,81411331,1.0,2015
1576,Gone with the Bullets,81387479,0,0.0,81387479,1.0,2014
1577,Tinker Tailor Soldier Spy,81244605,24149393,0.297243035399089,57095212,0.7027569646009111,2011
1578,Edge of Darkness,81126522,43313890,0.5339054224461884,37812632,0.46609457755381156,2010
1579,iPartment the Movie,81096321,0,0.0,81096321,1.0,2018
1580,Underworld: Blood Wars,81093313,30353973,0.37430919858953104,50739340,0.625690801410469,2016
1581,Doraemon the Movie: Nobita's Treasure Island,80920916,0,0.0,80920916,1.0,2018
1582,Sinbad: Legend of the Seven Seas,80773077,26483452,0.32787474469989547,54289625,0.6721252553001045,2003
1583,Hot Fuzz,80743363,23637265,0.292745609320236,57106098,0.707254390679764,2007
1584,A Dog's Way Home,80708134,42004346,0.5204474929379485,38703788,0.4795525070620515,2019
1585,The Rookie,80693537,75600072,0.9368788977486512,5093465,0.06312110225134883,2002
1586,The Rundown,80657921,47726342,0.5917130197293332,32931579,0.4082869802706668,2003
1587,Go Away Mr. Tumor,80606893,286639,0.0035560110225312867,80320254,0.9964439889774687,2015
1588,Vampires Suck,80547866,36661504,0.4551517727359779,43886362,0.5448482272640222,2010
1589,Caught in Time,80543319,0,0.0,80543319,1.0,2020
1590,Den of Thieves,80509622,44947622,0.5582888216764947,35562000,0.44171117832350526,2018
1591,Halloween,80460948,58272029,0.7242274724379335,22188919,0.2757725275620665,2007
1592,Muppets Most Wanted,80383113,51183113,0.6367396221641727,29200000,0.36326037783582726,2014
1593,Hereditary,80200936,44069456,0.5494880508626483,36131480,0.4505119491373517,2018
1594,Runaway Jury,80154140,49443628,0.6168568211199073,30710512,0.3831431788800928,2003
1595,Finding Forrester,80049764,51804714,0.6471563613854002,28245050,0.3528436386145998,2000
1596,Exit Wounds,79958599,51758599,0.6473174823886046,28200000,0.35268251761139535,2001
1597,The Wedding Ringer,79799880,64460211,0.8077732823658381,15339669,0.19222671763416185,2015
1598,The Grey,79781695,51580236,0.6465171741462751,28201459,0.353482825853725,2012
1599,Jackass: The Movie,79493831,64255312,0.8083056407232405,15238519,0.19169435927675949,2002
1600,Good Bye Lenin!,79316957,4064200,0.05123998894713018,75252757,0.9487600110528698,2003
1601,Letters to Juliet,79293444,53032453,0.6688125817816666,26260991,0.3311874182183334,2010
1602,Stealth,79268322,32116746,0.40516495353591564,47151576,0.5948350464640844,2005
1603,Paradox,79226860,0,0.0,79226860,1.0,2017
1604,Manchester by the Sea,78988148,47695371,0.603829463124012,31292777,0.396170536875988,2016
1605,Lady Bird,78965611,48958273,0.6199948608008617,30007338,0.3800051391991382,2017
1606,Paranormal Activity: The Ghost Dimension,78903124,18300124,0.2319315519116835,60603000,0.7680684480883165,2015
1607,The Boss,78844582,63285885,0.8026662504216207,15558697,0.1973337495783794,2016
1608,The Sentinel,78810595,36280697,0.4603530400956876,42529898,0.5396469599043123,2006
1609,Code Blue: The Movie,78778562,0,0.0,78778562,1.0,2018
1610,Spanish Affair,78768613,0,0.0,78768613,1.0,2014
1611,The Orphanage,78638987,7161284,0.09106531344306355,71477703,0.9089346865569364,2007
1612,Curse of the Golden Flower,78568977,6566773,0.08357971874827898,72002204,0.916420281251721,2006
1613,The Attorney,78547586,557236,0.007094247301247424,77990350,0.9929057526987526,2013
1614,Righteous Kill,78460699,40081410,0.5108469655617012,38379289,0.48915303443829883,2008
1615,The Family,78418811,36918811,0.47079024189744473,41500000,0.5292097581025552,2013
1616,Collateral Damage,78382433,40077257,0.5113040698800457,38305176,0.4886959301199543,2002
1617,Scary Movie V,78378744,32015787,0.4084753769465864,46362957,0.5915246230534136,2013
1618,R.I.P.D.,78324220,33618855,0.4292268087700075,44705365,0.5707731912299925,2013
1619,Priest,78309505,29137000,0.37207488414082046,49172505,0.6279251158591795,2011
1620,If I Stay,78274843,50474843,0.6448411911857811,27800000,0.3551588088142189,2014
1621,The Other Boleyn Girl,78199679,26814957,0.3429036709984449,51384722,0.6570963290015551,2008
1622,Duplicity,78176181,40572825,0.518992159517232,37603356,0.481007840482768,2009
1623,Tag,78130625,54730625,0.7005015638874001,23400000,0.2994984361125999,2018
1624,Head Full of Honey,78127384,0,0.0,78127384,1.0,2014
1625,Exorcist: The Beginning,78110021,41821986,0.5354240783010416,36288035,0.46457592169895845,2004
1626,Mirrors,78094714,30691439,0.3930027709685959,47403275,0.6069972290314041,2008
1627,The Left Ear,78015473,0,0.0,78015473,1.0,2015
1628,Shin Godzilla,77947607,1918403,0.024611441888139043,76029204,0.975388558111861,2016
1629,Orphan,77912251,41596251,0.5338858840055847,36316000,0.4661141159944153,2009
1630,Boonie Bears: The Wild Life,77864685,0,0.0,77864685,1.0,2021
1631,Tiny Times 4.0,77750000,0,0.0,77750000,1.0,2015
1632,Showtime,77741732,38082712,0.4898618929663157,39659020,0.5101381070336843,2002
1633,Tiny Times,77717014,23462,0.0003018901369525082,77693552,0.9996981098630475,2013
1634,The Number 23,77677553,35193167,0.4530674003080401,42484386,0.54693259969196,2007
1635,Suck Me Shakespeer,77676735,0,0.0,77676735,1.0,2013
1636,Windtalkers,77628265,40914068,0.5270511713742411,36714197,0.47294882862575893,2002
1637,Next,77621983,18211013,0.23461154039313836,59410970,0.7653884596068616,2007
1638,Hostage,77608617,34639939,0.4463414030429121,42968678,0.5536585969570879,2005
1639,The Haunting in Connecticut,77536359,55389516,0.7143682875281776,22146843,0.2856317124718224,2009
1640,Serendipity,77516304,50294317,0.6488224335360468,27221987,0.3511775664639532,2001
1641,The Back-up Plan,77477008,37490007,0.48388558060992753,39987001,0.5161144193900725,2010
1642,The Lives of Others,77356942,11286112,0.14589656349135413,66070830,0.8541034365086458,2006
1643,Diary of a Wimpy Kid: Dog Days,77229695,49008662,0.6345831354118386,28221033,0.3654168645881613,2012
1644,Fame,77211836,22455510,0.2908298929713315,54756326,0.7091701070286686,2009
1645,Fantastica: A Boonie Bears Adventure,77151096,0,0.0,77151096,1.0,2017
1646,Mike and Dave Need Wedding Dates,77068246,46009673,0.596999093504736,31058573,0.40300090649526393,2016
1647,Barbershop,77063924,75782105,0.983366808573101,1281819,0.01663319142689905,2002
1648,The Forever Purge,76994245,44539245,0.5784749886176558,32455000,0.4215250113823442,2021
1649,Drive,76976666,35061555,0.45548289919441304,41915111,0.544517100805587,2011
1650,"I, Frankenstein",76801179,19075290,0.248372358971208,57725889,0.751627641028792,2014
1651,United 93,76700659,31483450,0.4104717014230608,45217209,0.5895282985769392,2006
1652,Sanju,76693052,7909317,0.10312951165380665,68783735,0.8968704883461933,2018
1653,Coach Carter,76669554,67264877,0.8773349196735903,9404677,0.12266508032640962,2005
1654,The Ladykillers,76665191,39799191,0.519129874730241,36866000,0.480870125269759,2004
1655,The Book Thief,76586316,21488481,0.28057859578987976,55097835,0.7194214042101202,2013
1656,Bend It Like Beckham,76583333,32543449,0.4249416645264055,44039884,0.5750583354735945,2002
1657,The Unborn,76514050,42670410,0.5576807135421533,33843640,0.4423192864578466,2009
1658,Bad Santa,76488889,60060328,0.7852163730604061,16428561,0.2147836269395938,2003
1659,The Road to El Dorado,76432727,50863742,0.665470721723693,25568985,0.33452927827630696,2000
1660,Cold Pursuit,76419755,32138862,0.42055698817668286,44280893,0.5794430118233171,2019
1661,(T)Raumschiff Surprise - Periode 1,76341401,0,0.0,76341401,1.0,2004
1662,The Ides of March,76338111,40962534,0.5365934978401549,35375577,0.4634065021598452,2011
1663,Candyman,76298075,60073075,0.7873471906073646,16225000,0.2126528093926354,2021
1664,Tae Guk Gi: The Brotherhood of War,76287982,1111061,0.01456403709826798,75176921,0.985435962901732,2004
1665,Kubo and the Two Strings,76249438,48023088,0.6298156322148892,28226350,0.37018436778511077,2016
1666,Diary of a Wimpy Kid,76196538,64003625,0.8399807482066968,12192913,0.16001925179330326,2010
1667,There Will Be Blood,76181545,40222514,0.5279823873354105,35959031,0.4720176126645896,2007
1668,The Mechanic,76130093,29121498,0.38252282182290254,47008595,0.6174771781770975,2011
1669,Hero,76089199,0,0.0,76089199,1.0,2007
1670,If You Are the One 2,76085443,426894,0.005610718465554574,75658549,0.9943892815344454,2010
1671,Vice,76073488,47836282,0.6288167304751426,28237206,0.3711832695248573,2018
1672,The Pink Panther 2,76025134,35922978,0.4725144976396885,40102156,0.5274855023603116,2009
1673,Kate & Leopold,76019048,47121859,0.6198691017546023,28897189,0.38013089824539764,2001
1674,Death Race,76014335,36316032,0.47775241340991803,39698303,0.522247586590082,2008
1675,Widows,75984700,42402632,0.5580417110286676,33582068,0.4419582889713324,2018
1676,Revolutionary Road,75981180,22911480,0.3015415133063214,53069700,0.6984584866936786,2008
1677,Quo vado?,75878701,0,0.0,75878701,1.0,2016
1678,Sicario: Day of the Soldado,75837743,50072235,0.6602548153364743,25765508,0.33974518466352566,2018
1679,Elizabeth: The Golden Age,75782758,16383509,0.21619045588179833,59399249,0.7838095441182017,2007
1680,A Dog's Journey,75741734,22782371,0.30079019579879174,52959363,0.6992098042012083,2019
1681,Dreamcatcher,75715436,33715436,0.44529144625146183,42000000,0.5547085537485381,2003
1682,Bajrangi Bhaijaan,75547184,8178001,0.10825024265629808,67369183,0.8917497573437019,2015
1683,30 Days of Night,75513170,39569000,0.5240013099701681,35944170,0.47599869002983186,2007
1684,Stomp the Yard,75511123,61356221,0.8125454709500215,14154902,0.1874545290499785,2007
1685,Der Schuh des Manitu,75482094,0,0.0,75482094,1.0,2001
1686,Searching,75462037,26020957,0.3448218208050758,49441080,0.6551781791949242,2018
1687,The Change-Up,75450437,37081475,0.49146799507602584,38368962,0.5085320049239741,2011
1688,The Count of Monte Cristo,75395048,54234062,0.719331885033086,21160986,0.280668114966914,2002
1689,The Spy Who Dumped Me,75320680,33562069,0.4455890334500432,41758611,0.5544109665499568,2018
1690,1921,75159828,0,0.0,75159828,1.0,2021
1691,Dragon Wars: D-War,75108817,10977721,0.1461575543121655,64131096,0.8538424456878345,2007
1692,Larry Crowne,75055070,35608245,0.47442824315532584,39446825,0.5255717568446742,2011
1693,Easy A,75026216,58401464,0.7784140946146078,16624752,0.22158590538539222,2010
1694,The Kite Runner,75011029,15800078,0.21063673183312817,59210951,0.7893632681668719,2007
1695,Animal World,74922830,0,0.0,74922830,1.0,2018
1696,Boo! A Madea Halloween,74827344,73206343,0.9783367828744529,1621001,0.021663217125547047,2016
1697,A Madea Family Funeral,74747725,73257045,0.9800571856869222,1490680,0.019942814313077754,2019
1698,Crimson Peak,74679822,31090320,0.4163148648104705,43589502,0.5836851351895295,2014
1699,Escape from Planet Earth,74597643,57012977,0.7642731687916735,17584666,0.23572683120832652,2013
1700,From Hell,74558115,31602566,0.4238648737297074,42955549,0.5761351262702926,2001
1701,The King and the Clown,74466867,0,0.0,74466867,1.0,2005
1702,Thermae Romae,74285251,0,0.0,74285251,1.0,2012
1703,Hubble 3D,74249729,52522904,0.7073817602755156,21726825,0.29261823972448436,2010
1704,One Piece Film Z,74223861,0,0.0,74223861,1.0,2012
1705,August: Osage County,74188937,37738810,0.5086851426379111,36450127,0.4913148573620889,2013
1706,Eternal Sunshine of the Spotless Mind,74036715,34400301,0.4646384027168142,39636414,0.5353615972831858,2004
1707,Miracles from Heaven,73983003,61705123,0.8340445845378837,12277880,0.16595541546211634,2016
1708,Divine Secrets of the Ya-Ya Sisterhood,73839240,69599016,0.94257492357722,4240224,0.05742507642278008,2002
1709,Cats,73833415,27166770,0.3679468164922346,46666645,0.6320531835077654,2019
1710,Obsessed,73830347,68261644,0.9245743352662287,5568703,0.07542566473377132,2009
1711,Crying Out Love in the Center of the World,73611055,0,0.0,73611055,1.0,2004
1712,Perfect Stranger,73534117,23984949,0.3261744341065522,49549168,0.6738255658934478,2007
1713,The Core,73498611,31186896,0.4243195289772211,42311715,0.575680471022779,2003
1714,Charlie's Angels,73279888,17803077,0.24294629107511737,55476811,0.7570537089248827,2019
1715,War Room,73267874,67790117,0.9252365777666758,5477757,0.07476342223332426,2015
1716,To Rome with Love,73244881,16685867,0.22780932636097806,56559014,0.7721906736390219,2012
1717,"Dude, Where's My Car?",73180723,46729800,0.6385534070222291,26450923,0.36144659297777093,2000
1718,Here Comes the Boom,73100172,45290318,0.6195651359069305,27809854,0.3804348640930694,2012
1719,My Old Classmate,73052128,0,0.0,73052128,1.0,2014
1720,Without a Paddle,73029190,58169327,0.7965215963644127,14859863,0.20347840363558736,2004
1721,Bayside Shakedown the Final,72867395,0,0.0,72867395,1.0,2012
1722,The Best Man Holiday,72835710,70525195,0.9682777170703766,2310515,0.0317222829296234,2013
1723,Lady in the Water,72785169,42285169,0.580958587868361,30500000,0.4190414121316391,2006
1724,The Bélier Family,72751538,0,0.0,72751538,1.0,2014
1725,The One,72689126,43905746,0.6040208269941229,28783380,0.3959791730058771,2001
1726,"Yours, Mine & Ours",72662923,53412862,0.7350772552874043,19250061,0.26492274471259575,2005
1727,The Transporter Refueled,72629670,16029670,0.22070415575342694,56600000,0.779295844246573,2015
1728,Lord of War,72617068,24149632,0.3325613752403223,48467436,0.6674386247596777,2005
1729,Diary of a Wimpy Kid: Rodrick Rules,72526996,52698535,0.7266057868989914,19828461,0.27339421310100864,2011
1730,Amazing China,72506343,0,0.0,72506343,1.0,2018
1731,Serial (Bad) Weddings 2,72464368,0,0.0,72464368,1.0,2019
1732,Doctor Sleep,72381712,31581712,0.4363217051290525,40800000,0.5636782948709476,2019
1733,Second Act,72282227,39282227,0.5434562357908536,33000000,0.45654376420914644,2018
1734,Boys Over Flowers: Final,72243609,0,0.0,72243609,1.0,2008
1735,What Men Want,72216294,54611903,0.7562268841987377,17604391,0.24377311580126224,2019
1736,Around the World in 80 Days,72178895,24008137,0.33261990225813237,48170758,0.6673800977418676,2004
1737,Babylon A.D.,72109200,22532572,0.3124784632196724,49576628,0.6875215367803276,2008
1738,The Adventures of Sharkboy and Lavagirl 3-D,71992655,39177684,0.5441900149397185,32814971,0.4558099850602815,2005
1739,"O Brother, Where Art Thou?",71868327,45512588,0.6332774102282915,26355739,0.36672258977170846,2000
1740,Rules of Engagement,71732303,61335230,0.8550573093965769,10397073,0.14494269060342313,2000
1741,Funny People,71585235,51855045,0.7243818505310488,19730190,0.27561814946895125,2009
1742,Run All Night,71561644,26461644,0.3697741208963841,45100000,0.6302258791036159,2015
1743,Superhero Movie,71538062,25881068,0.36178039041650306,45656994,0.638219609583497,2008
1744,The Royal Tenenbaums,71441250,52364010,0.7329660385281612,19077240,0.2670339614718387,2001
1745,Brick Mansions,71416730,20396829,0.28560295325759105,51019901,0.714397046742409,2014
1746,Holes,71406573,67406573,0.9439827479187385,4000000,0.05601725208126148,2003
1747,Tidal Wave,71283278,0,0.0,71283278,1.0,2009
1748,Down to Earth,71186502,64186502,0.9016667513737365,7000000,0.09833324862626344,2001
1749,Pokémon: Zoroark: Master of Illusions,71143529,0,0.0,71143529,1.0,2010
1750,xXx: State of the Union,71022693,26873932,0.37838514515353566,44148761,0.6216148548464644,2005
1751,The Counselor,71009334,16973715,0.23903498376706364,54035619,0.7609650162329363,2013
1752,Anacondas: The Hunt for the Blood Orchid,70992898,32238923,0.45411476229636377,38753975,0.5458852377036362,2004
1753,Son of God,70829270,59700064,0.842872784090532,11129206,0.15712721590946793,2014
1754,I Am Not Madame Bovary,70826207,436798,0.006167180461887504,70389409,0.9938328195381125,2016
1755,Taxi 2004 Re-release,70778329,36611066,0.5172637799911891,34167263,0.4827362200088109,2004
1756,Brotherhood of the Wolf,70752904,11260096,0.15914676802523894,59492808,0.840853231974761,2001
1757,The Grudge 2,70711175,39143839,0.5535735900301473,31567336,0.4464264099698527,2006
1758,Hannah Montana and Miley Cyrus: Best of Both Worlds Concert,70642966,65281781,0.9241087215958628,5361185,0.07589127840413722,2008
1759,A Turtle's Tale: Sammy's Adventures,70627617,0,0.0,70627617,1.0,2010
1760,Children of Men,70455770,35552383,0.5046056980145133,34903387,0.4953943019854868,2006
1761,Departures,70442129,1498210,0.021268664381225617,68943919,0.9787313356187743,2008
1762,The House Bunny,70439696,48237389,0.6848040485580744,22202307,0.3151959514419256,2008
1763,Hitman's Wife's Bodyguard,70339504,38014727,0.5404463329738578,32324777,0.45955366702614225,2021
1764,Spirited Away 2018 Re-release,70186029,1175067,0.016742178133485795,69010962,0.9832578218665142,2018
1765,Think Like a Man Too,70181428,65182182,0.9287668241803231,4999246,0.07123317581967696,2014
1766,License to Wed,70181325,43799818,0.6240950566265313,26381507,0.37590494337346864,2007
1767,A Cinderella Story,70067909,51438175,0.7341188817265832,18629734,0.2658811182734167,2004
1768,See You Tomorrow,70065569,0,0.0,70065569,1.0,2016
1769,3:10 to Yuma,70016220,53606916,0.7656356769902746,16409304,0.23436432300972546,2007
1770,The Hills Have Eyes,70008952,41778863,0.5967645823351276,28230089,0.40323541766487236,2006
1771,The Cabin in the Woods,69935600,42073277,0.6016002865493397,27862323,0.39839971345066033,2012
1772,Sole a catinelle,69903094,0,0.0,69903094,1.0,2013
1773,Curious George,69865924,58360760,0.8353251006885702,11505164,0.1646748993114297,2006
1774,The Brave One,69787394,36793804,0.5272270805813439,32993590,0.472772919418656,2007
1775,The Dilemma,69721966,48475290,0.6952656785380952,21246676,0.3047343214619048,2011
1776,After,69518232,12138565,0.1746098059570905,57379667,0.8253901940429095,2019
1777,Exit,69501772,470699,0.006772474808268198,69031073,0.9932275251917319,2019
1778,Because I Said So,69485490,42674040,0.6141431829868366,26811450,0.3858568170131635,2007
1779,Mr. Magorium's Wonder Emporium,69474661,32061555,0.46148559112796533,37413106,0.5385144088720346,2007
1780,The Last Exorcism,69432527,41034350,0.5909960615433167,28398177,0.40900393845668326,2010
1781,A Very Long Engagement,69424389,6524389,0.0939783423949183,62900000,0.9060216576050817,2004
1782,Playing with Fire,69412425,44451847,0.6404018732957392,24960578,0.3595981267042608,2019
1783,13 Hours,69411370,52853219,0.7614490104431018,16558151,0.23855098955689824,2015
1784,The X Files: I Want to Believe,69363381,20982478,0.302500796493758,48380903,0.697499203506242,2008
1785,Finding Nemo 2012 3D Release,69328283,41128283,0.5932396017942634,28200000,0.4067603982057366,2012
1786,E.T. the Extra-Terrestrial 20th Anniversary,69177751,35306015,0.5103666206205518,33871736,0.4896333793794482,2002
1787,The Men Who Stare at Goats,69095771,32428195,0.4693224278516264,36667576,0.5306775721483736,2009
1788,Takers,69055695,57744720,0.8362050371080908,11310975,0.1637949628919092,2010
1789,Anna Karenina,68929150,12816367,0.18593536986891612,56112783,0.8140646301310839,2012
1790,John Tucker Must Die,68844775,41011711,0.5957127610628403,27833064,0.40428723893715973,2006
1791,Bestseller,68813389,0,0.0,68813389,1.0,2010
1792,Running Man,68782475,310978,0.004521180722269735,68471497,0.9954788192777303,2015
1793,Land of the Lost,68777554,49438370,0.718815472850343,19339184,0.28118452714965697,2009
1794,House of Wax,68766121,32064800,0.46628775236573256,36701321,0.5337122476342675,2005
1795,The Nut Job 2: Nutty by Nature,68743485,28370522,0.41270124725273966,40372963,0.5872987527472603,2017
1796,The Sweetest Thing,68696770,24718164,0.35981551971075204,43978606,0.6401844802892479,2002
1797,Letters from Iwo Jima,68673228,13756082,0.20031215075545888,54917146,0.7996878492445412,2006
1798,Tales from Earthsea,68625104,0,0.0,68625104,1.0,2006
1799,The Call,68572631,51872378,0.7564589143444124,16700253,0.24354108565558757,2013
1800,One Direction: This Is Us,68532898,28873374,0.4213067715303678,39659524,0.5786932284696322,2013
1801,Looney Tunes: Back in Action,68514844,20991364,0.3063768779799017,47523480,0.6936231220200983,2003
1802,Dan in Real Life,68471669,47642963,0.6958054870840085,20828706,0.3041945129159916,2007
1803,Thir13en Ghosts,68467960,41867960,0.6114971148548898,26600000,0.3885028851451102,2001
1804,Pokémon 3 the Movie: Spell of the Unown,68411275,17052128,0.24925902930474544,51359147,0.7507409706952546,2001
1805,Ghost Ship,68349884,30113491,0.4405785238786945,38236393,0.5594214761213054,2002
1806,Stalingrad,68316452,1013945,0.014841886109659207,67302507,0.9851581138903408,2013
1807,Open Range,68296293,58331254,0.8540910705065646,9965039,0.1459089294934353,2003
1808,Star Wars: The Clone Wars,68282844,35161554,0.514939799519774,33121290,0.485060200480226,2008
1809,The Watch,68267862,35353000,0.5178571433802922,32914862,0.4821428566197078,2012
1810,Moonrise Kingdom,68263166,45512466,0.6667207026407185,22750700,0.3332792973592816,2012
1811,Saw VI,68234154,27693292,0.40585675027201185,40540862,0.5941432497279882,2009
1812,Frequency,68106245,45010278,0.6608832714239348,23095967,0.33911672857606523,2000
1813,Fearless,68072848,24633730,0.3618730628105937,43439118,0.6381269371894063,2006
1814,The Yin-Yang Master: Dream of Eternity,68000000,0,0.0,68000000,1.0,2020
1815,Shoplifters,67999335,3313513,0.04872860889007223,64685822,0.9512713911099278,2018
1816,Prime,67937494,22827153,0.33600228174445174,45110341,0.6639977182555482,2005
1817,Legion,67918658,40168080,0.591414512342102,27750578,0.4085854876578981,2010
1818,The American,67876281,35606376,0.5245775913975016,32269905,0.4754224086024984,2010
1819,A Beautiful Day in the Neighborhood,67760877,61704055,0.9106147637374882,6056822,0.08938523626251177,2019
1820,Jersey Boys,67647013,47047013,0.6954780545890474,20600000,0.30452194541095257,2014
1821,Bandits,67631903,41575141,0.614726765857823,26056762,0.38527323414217696,2001
1822,The Secret of the Gods,67537798,0,0.0,67537798,1.0,2012
1823,12 Strong,67450815,45819713,0.6793055502739292,21631102,0.32069444972607075,2018
1824,The Next Three Days,67448651,21148651,0.3135518751887269,46300000,0.6864481248112732,2010
1825,Star Trek: Nemesis,67336470,43254409,0.6423622889646576,24082061,0.35763771103534236,2002
1826,American Assassin,67234188,36249674,0.5391553773208356,30984514,0.4608446226791644,2017
1827,Boogeyman,67192859,46752382,0.6957939086949702,20440477,0.3042060913050299,2005
1828,War,67179155,4654000,0.06927744178979328,62525155,0.9307225582102068,2019
1829,The Girl Who Played with Fire,67153225,7638241,0.11374347248400951,59514984,0.8862565275159905,2009
1830,"Lust, Caution",67091915,4604982,0.06863691400074062,62486933,0.9313630859992593,2007
1831,When a Stranger Calls,67062123,47860214,0.7136698311802625,19201909,0.2863301688197375,2006
1832,Skyline,66984887,21393620,0.31937980279044137,45591267,0.6806201972095586,2010
1833,The Giver,66980456,45090374,0.6731870263767687,21890082,0.32681297362323125,2014
1834,Madea's Witness Protection,66899242,65653242,0.9813749758181116,1246000,0.018625024181888338,2012
1835,Mulan,66800000,0,0.0,66800000,1.0,2020
1836,Selma,66787908,52076908,0.779735577284439,14711000,0.22026442271556101,2014
1837,A Violent Prosecutor,66736633,0,0.0,66736633,1.0,2015
1838,Thirteen Days,66579890,34592089,0.5195576171723925,31987801,0.48044238282760754,2000
1839,Victoria & Abdul,66558465,22245070,0.33421849497280326,44313395,0.6657815050271968,2017
1840,Take the Lead,66499627,34742066,0.5224400130845847,31757561,0.47755998691541535,2006
1841,Street Kings,66476363,26418667,0.39741444639502915,40057696,0.6025855536049708,2008
1842,Not Another Teen Movie,66468332,38252284,0.5754963732202577,28216048,0.4245036267797423,2001
1843,"Love, Simon",66316289,40826341,0.615630663531248,25489948,0.38436933646875204,2018
1844,Mile 22,66308758,36108758,0.5445548836851989,30200000,0.4554451163148011,2018
1845,One Piece Film: Gold,66207073,423593,0.00639800221949096,65783480,0.9936019977805091,2016
1846,August Rush,66122026,31664162,0.47887464912221533,34457864,0.5211253508777847,2007
1847,Barbershop 2: Back in Business,65991448,65111277,0.9866623475211516,880171,0.013337652478848471,2004
1848,Bad Company,65977295,30160161,0.45712939580199524,35817134,0.5428706041980048,2002
1849,Flags of Our Fathers,65900249,33602376,0.50989755744322,32297873,0.49010244255678004,2006
1850,Life of the Party,65859911,53059911,0.8056480823364611,12800000,0.1943519176635389,2018
1851,Beijing Love Story,65842375,428318,0.0065052027664554936,65414057,0.9934947972335445,2014
1852,Stuck on You,65784503,33832741,0.5142965205650334,31951762,0.4857034794349666,2003
1853,Sweet November,65754228,25288103,0.384585201121972,40466125,0.6154147988780281,2001
1854,K-19: The Widowmaker,65716126,35168966,0.5351649304464478,30547160,0.4648350695535522,2002
1855,16 Blocks,65664721,36895141,0.5618715870276827,28769580,0.43812841297231736,2006
1856,The Age of Adaline,65663276,42629776,0.6492179281460158,23033500,0.35078207185398425,2015
1857,Matchstick Men,65565672,36906460,0.5628930334154129,28659212,0.43710696658458714,2003
1858,Taxi 3,65497208,497208,0.007591285417845597,65000000,0.9924087145821544,2003
1859,Taking Lives,65470529,32682342,0.4991916591967662,32788187,0.5008083408032338,2004
1860,Eiga Doraemon: Nobita no getsumen tansaki,65406606,0,0.0,65406606,1.0,2019
1861,Moonlight,65336603,27854932,0.42632966394044086,37481671,0.5736703360595592,2016
1862,Underdog,65270477,43760605,0.6704502098245735,21509872,0.32954979017542646,2007
1863,The House That Never Dies,65220000,0,0.0,65220000,1.0,2014
1864,Taxi 4,65125001,0,0.0,65125001,1.0,2007
1865,Something Borrowed,65100369,39046489,0.5997890580312993,26053880,0.40021094196870066,2011
1866,Space Chimps,65097693,30105968,0.4624736547883502,34991725,0.5375263452116498,2008
1867,Zathura: A Space Adventure,65079104,29258869,0.44958930288898874,35820235,0.5504106971110112,2005
1868,Stand by Me Doraemon 2,65066630,0,0.0,65066630,1.0,2020
1869,28 Weeks Later,65048678,28638916,0.440268993629663,36409762,0.559731006370337,2007
1870,K-PAX,65001485,50338485,0.7744205382384726,14663000,0.22557946176152746,2001
1871,The Benchwarmers,64962629,59843754,0.921202773366823,5118875,0.07879722663317705,2006
1872,The Pirates,64858224,415775,0.006410520892462304,64442449,0.9935894791075377,2014
1873,The Bank Job,64822796,30060660,0.4637359363517735,34762136,0.5362640636482264,2008
1874,Lions for Lambs,64811540,15002854,0.2314843004810563,49808686,0.7685156995189437,2007
1875,Hot Tub Time Machine,64735752,50287556,0.7768127262969,14448196,0.22318727370309996,2010
1876,God's Not Dead,64667874,60755732,0.9395040882277961,3912142,0.060495911772203925,2014
1877,The Darkest Hour,64626786,21443494,0.3318050506178661,43183292,0.6681949493821339,2011
1878,Happy Death Day 2U,64600152,28148130,0.43572854131984085,36452022,0.5642714586801592,2019
1879,L Storm,64517456,0,0.0,64517456,1.0,2018
1880,Monster Trucks,64493915,33370166,0.5174157282900255,31123749,0.4825842717099745,2016
1881,Monk Comes Down the Mountain,64455686,0,0.0,64455686,1.0,2015
1882,Miracle,64445708,64378093,0.9989508222952567,67615,0.0010491777047433478,2004
1883,Baby Mama,64444713,60494212,0.9386993778682823,3950501,0.061300622131717775,2008
1884,Kiss of the Dragon,64437847,36845124,0.5717932195965517,27592723,0.4282067804034483,2001
1885,Capernaum,64417003,1661096,0.025786607923997954,62755907,0.974213392076002,2018
1886,Fences,64414761,57682904,0.8954920130806664,6731857,0.10450798691933359,2016
1887,Zhongkui: Snow Girl and the Dark Crystal,64325947,165428,0.002571714956641058,64160519,0.9974282850433589,2015
1888,Isle of Dogs,64241499,32015231,0.49835747139088393,32226268,0.5016425286091161,2018
1889,Suck Me Shakespeer 3,64236772,0,0.0,64236772,1.0,2017
1890,Thunder and the House of Magic,64197205,4091,6.372551577595941e-05,64193114,0.9999362744842241,2013
1891,The Danish Girl,64191523,11114018,0.1731384064528271,53077505,0.8268615935471729,2015
1892,The Boy,64188367,35819556,0.5580381255064488,28368811,0.4419618744935511,2015
1893,The Grandmaster,64076736,6594959,0.10292282990194757,57481777,0.8970771700980524,2013
1894,The Rescue,64042765,18797,0.0002935070027035841,64023968,0.9997064929972964,2020
1895,The Pirate Fairy,63998725,0,0.0,63998725,1.0,2014
1896,The Inbetweeners 2,63852235,0,0.0,63852235,1.0,2014
1897,Hanna,63782078,40259119,0.6311979832328448,23522959,0.3688020167671552,2011
1898,High Crimes,63781810,41543917,0.651344278251119,22237893,0.34865572174888104,2002
1899,Precious,63649529,47566524,0.7473193399435839,16083005,0.25268066005641615,2009
1900,"Hail, Caesar!",63647656,30498085,0.4791705919225054,33149571,0.5208294080774947,2016
1901,Elite Squad 2: The Enemy Within,63618850,100119,0.0015737316848701288,63518731,0.9984262683151298,2010
1902,Footloose 2011 Re-release,63543328,51802742,0.815234952755386,11740586,0.18476504724461396,2011
1903,Conan the Barbarian,63523283,21295021,0.33523174487061697,42228262,0.664768255129383,2011
1904,Begin Again,63464861,16170632,0.25479661887229216,47294229,0.7452033811277078,2014
1905,Colombiana,63458440,36665854,0.5777931824356224,26792586,0.42220681756437756,2011
1906,Side Effects,63414135,32172757,0.5073436229950941,31241378,0.49265637700490594,2013
1907,Madea's Family Reunion,63368939,63318000,0.9991961519191602,50939,0.0008038480808397313,2006
1908,The Host,63365859,26627201,0.42021368320754554,36738658,0.5797863167924544,2013
1909,The Hundred Regiments Offensive,63230000,0,0.0,63230000,1.0,2015
1910,Detective Conan: Crimson Love Letter,63144805,0,0.0,63144805,1.0,2017
1911,Jeepers Creepers 2,63102666,35667218,0.5652252156826464,27435448,0.43477478431735356,2003
1912,The Longest Ride,62944815,37446117,0.5949039170263667,25498698,0.4050960829736333,2015
1913,Unfriended,62882090,32482090,0.5165555088897331,30400000,0.4834444911102668,2015
1914,Piglet's Big Movie,62870546,23103423,0.36747609922140645,39767123,0.6325239007785936,2003
1915,The Mountain Between Us,62832209,30348555,0.48300951825519933,32483654,0.5169904817448007,2017
1916,The Star,62812974,40852824,0.65038830990553,21960150,0.34961169009446996,2017
1917,Inkheart,62803180,17303424,0.27551827789611927,45499756,0.7244817221038807,2008
1918,Little Nicholas,62792067,0,0.0,62792067,1.0,2009
1919,The Nice Guys,62788218,36261763,0.5775249585837904,26526455,0.4224750414162097,2016
1920,The Reaping,62771059,25126214,0.4002834172353218,37644845,0.5997165827646782,2007
1921,Beauty and the Beast 2012 3D Release,62767829,47617067,0.7586221757008674,15150762,0.2413778242991326,2012
1922,Proof of Life,62761005,32598931,0.5194137824912141,30162074,0.4805862175087859,2000
1923,Devil,62695489,33601190,0.5359427055429777,29094299,0.46405729445702226,2010
1924,Runner Runner,62675095,19316646,0.3082028994132358,43358449,0.6917971005867641,2013
1925,After the Sunset,62657868,28331233,0.45215762847213375,34326635,0.5478423715278662,2004
1926,How to Be a Latin Lover,62547032,32149404,0.5140036700702281,30397628,0.4859963299297719,2017
1927,The White Haired Witch of Lunar Kingdom,62515046,0,0.0,62515046,1.0,2014
1928,Andhadhun,62475342,1193046,0.019096270013215774,61282296,0.9809037299867842,2018
1929,Snow Day,62464731,60020107,0.9608639313599221,2444624,0.03913606864007787,2000
1930,Year One,62357900,43337279,0.6949765627129842,19020621,0.30502343728701575,2009
1931,Like Mike,62274780,51432760,0.8259003082788892,10842020,0.17409969172111087,2002
1932,Honey,62228395,30308417,0.4870512408362774,31919978,0.5129487591637226,2003
1933,28 Days,62198945,37170488,0.5976064063466028,25028457,0.40239359365339716,2000
1934,47 Meters Down,62187529,44307191,0.7124771109654477,17880338,0.28752288903455225,2017
1935,Two Brothers,62172050,19176754,0.30844654470939914,42995296,0.6915534552906009,2004
1936,Captain Corelli's Mandolin,62112895,25543895,0.41124946760250025,36569000,0.5887505323974997,2001
1937,Brooklyn,62076141,38322743,0.6173506017392415,23753398,0.3826493982607585,2015
1938,Snakes on a Plane,62022014,34020814,0.5485280436072263,28001200,0.4514719563927737,2006
1939,Friday Night Lights,61950770,61255921,0.9887838520812574,694849,0.011216147918742576,2004
1940,The Imaginarium of Doctor Parnassus,61808775,7689607,0.12440963277463435,54119168,0.8755903672253657,2009
1941,"Dragon Ball Z: Resurrection ""F""",61768190,8008363,0.1296518968744268,53759827,0.8703481031255732,2015
1942,Valiant,61746888,19478106,0.3154508126790131,42268782,0.6845491873209869,2005
1943,White Snake,61631776,34730,0.000563508018980339,61597046,0.9994364919810197,2019
1944,"Everything, Everything",61621140,34121140,0.5537245821807256,27500000,0.4462754178192744,2017
1945,Woman in Gold,61619773,33307793,0.540537418078447,28311980,0.459462581921553,2015
1946,Ninja Assassin,61601280,38122883,0.6188651112444417,23478397,0.38113488875555834,2009
1947,The Face Reader,61559184,515876,0.008380163063889865,61043308,0.9916198369361101,2013
1948,Krampus,61548707,42725475,0.694173396688902,18823232,0.305826603311098,2015
1949,From Up on Poppy Hill,61459425,1002895,0.0163180016734618,60456530,0.9836819983265382,2011
1950,Bombshell,61404394,31762808,0.5172725587032094,29641586,0.48272744129679057,2019
1951,A History of Violence,61385065,31504633,0.5132296104923894,29880432,0.4867703895076107,2005
1952,Ashfall,61354854,372562,0.006072249801132279,60982292,0.9939277501988677,2019
1953,Astérix and Obélix: God Save Britannia,61319383,0,0.0,61319383,1.0,2012
1954,In Good Company,61315215,45806659,0.7470683907738072,15508556,0.2529316092261929,2004
1955,The Legend of Hercules,61279452,18848538,0.30758333152195944,42430914,0.6924166684780406,2013
1956,The Walk,61181942,10137502,0.16569434817874856,51044440,0.8343056518212515,2014
1957,Doraemon: Great Adventure in the Antarctic Kachi Kochi,61153455,0,0.0,61153455,1.0,2017
1958,Crossroads,61141030,37191304,0.6082871682076668,23949726,0.39171283179233324,2002
1959,My Super Ex-Girlfriend,61108981,22530295,0.36869040575230666,38578686,0.6313095942476933,2006
1960,Ma,61105672,45896028,0.7510927627144007,15209644,0.24890723728559927,2019
1961,Marie Antoinette,60917189,15962471,0.2620355807947737,44954718,0.7379644192052263,2006
1962,Snatched,60845711,45852178,0.7535811028652455,14993533,0.24641889713475448,2017
1963,Kick-Ass 2,60795985,28795985,0.4736494523445915,32000000,0.5263505476554085,2013
1964,Zoolander,60780981,45172250,0.7431971195068404,15608731,0.2568028804931595,2001
1965,127 Hours,60738797,18335230,0.301870153931432,42403567,0.698129846068568,2010
1966,Taxi 2,60726164,626164,0.010311272090231156,60100000,0.9896887279097688,2000
1967,500 Days of Summer,60722734,32391374,0.5334307575808428,28331360,0.4665692424191572,2009
1968,The Wild Thornberrys,60694737,40108697,0.660826605114048,20586040,0.339173394885952,2002
1969,Why Did I Get Married Too?,60673972,60095852,0.9904716968257822,578120,0.009528303174217769,2010
1970,Love You Forever,60670799,0,0.0,60670799,1.0,2020
1971,What a Beautiful Day,60661950,0,0.0,60661950,1.0,2011
1972,The Founding of an Army,60600361,0,0.0,60600361,1.0,2017
1973,Evangelion: 3.0 You Can (Not) Redo,60488344,174945,0.002892210109107963,60313399,0.997107789890892,2012
1974,21 Grams,60427839,16290476,0.2695856126842464,44137363,0.7304143873157536,2003
1975,Limit of Love: Umizaru,60369589,0,0.0,60369589,1.0,2006
1976,The Ghost Writer,60331447,15541549,0.2576027888076346,44789898,0.7423972111923653,2010
1977,My Little Pony: The Movie,60330833,21885107,0.3627516132588456,38445726,0.6372483867411544,2017
1978,Secretariat,60321861,59713955,0.9899222936772458,607906,0.0100777063227542,2010
1979,The Perfect Guy,60273173,57027435,0.9461495415215655,3245738,0.05385045847843451,2015
1980,3 Idiots,60262836,6532874,0.10840634848316796,53729962,0.891593651516832,2009
1981,The International,60253843,25450527,0.42238844416944493,34803316,0.5776115558305551,2009
1982,A Haunted House,60159584,40041683,0.6655910885288037,20117901,0.33440891147119634,2013
1983,The Crimson Rivers,60094966,594966,0.009900429929521884,59500000,0.9900995700704781,2001
1984,Beautiful Creatures,60052138,19452138,0.323920823601651,40600000,0.676079176398349,2013
1985,Morning Glory,60040976,31011732,0.5165094584738262,29029244,0.4834905415261737,2010
1986,My Best Summer,60011073,0,0.0,60011073,1.0,2019
1987,Forever Young,59981902,149761,0.0024967697756566637,59832141,0.9975032302243433,2015
1988,Son of the Mask,59981548,17018422,0.28372762236813226,42963126,0.7162723776318677,2005
1989,Keeping the Faith,59945183,37047880,0.6180293085434404,22897303,0.3819706914565596,2000
1990,Adrift,59945012,31445012,0.5245642790095696,28500000,0.47543572099043035,2018
1991,Green Zone 2010 Re-release,59828889,0,0.0,59828889,1.0,2010
1992,Next Friday,59827328,57328603,0.9582343874692181,2498725,0.04176561253078192,2000
1993,Good Luck Chuck,59768495,35017297,0.5858821942898177,24751198,0.41411780571018225,2007
1994,Quartet,59520298,18390117,0.3089721929819639,41130181,0.6910278070180361,2012
1995,The Flintstones in Viva Rock Vegas,59468275,35268275,0.5930603334298834,24200000,0.4069396665701166,2000
1996,Rock of Ages,59418613,38518613,0.6482583664482373,20900000,0.35174163355176263,2012
1997,Miss Granny,59396311,234573,0.003949285671967069,59161738,0.9960507143280329,2015
1998,One Day,59389433,13843771,0.23310158559688557,45545662,0.7668984144031145,2011
1999,Molly's Game,59284015,28780744,0.48547224745152634,30503271,0.5145277525484736,2017
2000,Jeepers Creepers,59217789,37904175,0.6400808885316539,21313614,0.3599191114683461,2001
2001,The Devotion of Suspect X,59035664,686435,0.011627463019641822,58349229,0.9883725369803582,2017
2002,The Gift,58978653,43787265,0.742425653566554,15191388,0.257574346433446,2015
2003,Miss Granny,58940254,0,0.0,58940254,1.0,2014
2004,Under the Tuscan Sun,58878723,43610723,0.7406873107624974,15268000,0.25931268923750267,2003
2005,A Walk Among the Tombstones,58834384,26307600,0.44714668891578774,32526784,0.5528533110842122,2014
2006,Shock Wave,58815633,0,0.0,58815633,1.0,2017
2007,Agent Cody Banks,58795814,47938330,0.8153357652298172,10857484,0.1846642347701828,2003
2008,Invincible,58480828,57806952,0.98847697573639,673876,0.011523024263609948,2006
2009,Monster,58469210,34469210,0.5895275479179555,24000000,0.4104724520820445,2003
2010,The Tree of Life,58409247,13303319,0.22776049484082547,45105928,0.7722395051591745,2011
2011,Are We Done Yet?,58388068,49662533,0.8505596211883565,8725535,0.14944037881164352,2007
2012,Beginning of the Great Revival,58309289,151000,0.0025896388481087464,58158289,0.9974103611518913,2011
2013,Little Nicky,58292295,39464775,0.6770152899281114,18827520,0.32298471007188856,2000
2014,Must Love Dogs,58231520,43894863,0.7537990249953976,14336657,0.2462009750046023,2005
2015,Cloudy Mountain,58200000,0,0.0,58200000,1.0,2021
2016,Huo guo ying xiong,58106427,779818,0.013420511985705126,57326609,0.9865794880142948,2016
2017,Jue ji,58089494,350456,0.0060330358532646195,57739038,0.9939669641467354,2016
2018,Doom,58072119,28212337,0.4858155253470258,29859782,0.5141844746529741,2005
2019,The Eye,58010320,31418697,0.5416053040217672,26591623,0.45839469597823285,2008
2020,Bowling for Columbine,58008423,21576018,0.3719462947648137,36432405,0.6280537052351862,2002
2021,Sky Captain and the World of Tomorrow,57947036,37762677,0.6516757302306195,20184359,0.3483242697693804,2004
2022,Aliens in the Attic,57881056,25200412,0.4353827269495567,32680644,0.5646172730504433,2009
2023,Snitch,57824674,42930462,0.7424246265530179,14894212,0.25757537344698217,2013
2024,Dolphin Tale 2,57824533,42024533,0.7267595745217692,15800000,0.27324042547823085,2014
2025,Nine Lives,57814445,19700032,0.3407458464748732,38114413,0.6592541535251268,2016
2026,Heartbreakers,57756408,40336607,0.6983918909915589,17419801,0.3016081090084411,2001
2027,That's My Boy,57719093,36931089,0.6398418110970663,20788004,0.3601581889029337,2012
2028,Cellular,57678321,32003620,0.5548639323256306,25674701,0.44513606767436936,2004
2029,The Motorcycle Diaries,57663224,16781387,0.2910240849523086,40881837,0.7089759150476914,2004
2030,Goldbuster,57628292,186135,0.0032299239408310073,57442157,0.996770076059169,2017
2031,Ready or Not,57615777,28714231,0.4983744469852416,28901546,0.5016255530147584,2019
2032,Drumline,57588485,56399184,0.9793482846440569,1189301,0.02065171535594312,2002
2033,Avatar 2021 Re-release,57566409,0,0.0,57566409,1.0,2021
2034,Derailed,57479076,36024076,0.6267337352465443,21455000,0.3732662647534557,2005
2035,The Mist,57470220,25594957,0.4453603448881873,31875263,0.5546396551118127,2007
2036,Seven Dwarves,57410311,0,0.0,57410311,1.0,2004
2037,Belle: The Dragon and the Freckled Princess,57326347,0,0.0,57326347,1.0,2021
2038,The Physician,57284237,0,0.0,57284237,1.0,2013
2039,Smokin' Aces,57232879,35787686,0.6252994192376728,21445193,0.3747005807623272,2007
2040,Walking Tall,57223890,46437717,0.8115092664969124,10786173,0.18849073350308762,2004
2041,Prom Night,57197876,43869350,0.766975158308326,13328526,0.233024841691674,2008
2042,She's the Man,57194667,33741133,0.5899349497043143,23453534,0.4100650502956858,2006
2043,Jade Dynasty,57149764,0,0.0,57149764,1.0,2019
2044,Killer Elite,57084522,25124966,0.44013622466699465,31959556,0.5598637753330054,2011
2045,Gekijouban Tenpesuto 3D,57082491,0,0.0,57082491,1.0,2011
2046,The 15:17 to Paris,57076286,36276286,0.6355754472181319,20800000,0.36442455278186814,2018
2047,The Descent,57051053,26024456,0.45616083545381714,31026597,0.5438391645461829,2005
2048,All the Money in the World,56996304,25113707,0.44061992160053043,31882597,0.5593800783994696,2017
2049,Elektra,56995646,24409722,0.4282734509229003,32585924,0.5717265490770996,2005
2050,Zoolander 2,56722693,28848693,0.5085917377018754,27874000,0.4914082622981247,2016
2051,Murder by Numbers,56714147,31945749,0.5632765489711059,24768398,0.4367234510288941,2002
2052,Into the Wild,56674477,18354356,0.32385576315066833,38320121,0.6761442368493317,2007
2053,You Are My Sunshine,56640000,0,0.0,56640000,1.0,2015
2054,Das perfekte Geheimnis,56573047,0,0.0,56573047,1.0,2019
2055,Cradle 2 the Grave,56489558,34712347,0.6144913897184325,21777211,0.3855086102815674,2003
2056,The Big Sick,56411585,42873127,0.7600057151381228,13538458,0.2399942848618772,2017
2057,Vicky the Viking,56390258,0,0.0,56390258,1.0,2009
2058,15 Minutes,56359980,24403552,0.43299433392275866,31956428,0.5670056660772413,2001
2059,Lucky Number Slevin,56308881,22495466,0.3995012083440266,33813415,0.6004987916559734,2006
2060,Frida,56298474,25885000,0.4597815564237141,30413474,0.5402184435762859,2002
2061,A or B,56239049,0,0.0,56239049,1.0,2018
2062,Eastern Promises,56106607,17266000,0.30773559342128814,38840607,0.6922644065787118,2007
2063,Nezha Reborn,56088478,0,0.0,56088478,1.0,2021
2064,Kicking & Screaming,56070433,52842724,0.9424347409623178,3227709,0.05756525903768212,2005
2065,The Big Shot,56040681,0,0.0,56040681,1.0,2019
2066,Remember Me,56032889,19068240,0.3403044237108674,36964649,0.6596955762891327,2010
2067,The Odd Life of Timothy Green,56012642,51854875,0.9257709179295631,4157767,0.07422908207043688,2012
2068,"Definitely, Maybe",55990299,32241649,0.5758434867440161,23748650,0.42415651325598386,2008
2069,Gongjo,55972241,475618,0.008497390697649572,55496623,0.9915026093023505,2017
2070,Under the Sea 3D,55902624,36262926,0.6486802122204496,19639698,0.35131978777955036,2009
2071,Tyler Perry's Why Did I Get Married?,55862886,55204525,0.9882146976796007,658361,0.011785302320399272,2007
2072,Firestorm,55754766,0,0.0,55754766,1.0,2013
2073,Dallas Buyers Club,55736588,27298285,0.4897731630073947,28438303,0.5102268369926053,2013
2074,Dragonball Evolution,55720772,9362785,0.16803042499124024,46357987,0.8319695750087598,2009
2075,Pay It Forward,55707411,33519628,0.6017085949300355,22187783,0.3982914050699646,2000
2076,All Eyez on Me,55668698,44922302,0.806958014358446,10746396,0.1930419856415539,2017
2077,The Irony of Fate 2,55639741,0,0.0,55639741,1.0,2007
2078,Cop Out,55611001,44875481,0.8069533040773713,10735520,0.19304669592262869,2010
2079,The Lizzie McGuire Movie,55534455,42734455,0.7695124585268731,12800000,0.23048754147312692,2003
2080,Out of Time,55495563,41088845,0.7403987414273101,14406718,0.25960125857268984,2003
2081,Spanglish,55470154,42726869,0.7702677191053048,12743285,0.2297322808946952,2004
2082,Nobody,55405035,27268035,0.49215806830552494,28137000,0.5078419316944751,2021
2083,Lawless,55404159,37400127,0.6750418682467502,18004032,0.3249581317532498,2012
2084,Silent Hill: Revelation,55362705,17529157,0.31662392579986837,37833548,0.6833760742001317,2011
2085,Rugrats Go Wild,55250496,39402572,0.7131623216558997,15847924,0.2868376783441003,2003
2086,Extremely Loud & Incredibly Close,55247881,31847881,0.5764543440136646,23400000,0.4235456559863355,2011
2087,The Ant Bully,55181129,28142535,0.5100028852254908,27038594,0.48999711477450925,2006
2088,The Mothman Prophecies,55157539,35746370,0.6480776816384066,19411169,0.3519223183615933,2002
2089,End of Watch,55078146,41003371,0.744458083247755,14074775,0.2555419167522451,2012
2090,Hellboy,55064690,21903748,0.39778209956325916,33160942,0.6022179004367408,2019
2091,Wolf Children,55045228,0,0.0,55045228,1.0,2012
2092,We Own the Night,55033767,28563179,0.5190118822867422,26470588,0.4809881177132578,2007
2093,Barbershop: The Next Cut,55030051,54030051,0.9818281106081476,1000000,0.018171889391852464,2016
2094,Veda - Atatürk,55024621,0,0.0,55024621,1.0,2010
2095,The Messengers,55010659,35374833,0.6430541579223764,19635826,0.35694584207762353,2007
2096,Downsizing,55003890,24449754,0.44450954287051336,30554136,0.5554904571294866,2017
2097,Analyze That,55003135,32130627,0.5841599210663174,22872508,0.4158400789336826,2002
2098,Suspect X,54846110,0,0.0,54846110,1.0,2008
2099,St. Vincent,54837234,44137712,0.8048858190039272,10699522,0.19511418099607286,2014
2100,The Three Stooges,54819301,44338224,0.8088068105793614,10481077,0.19119318942063854,2012
2101,The Crazies,54806823,39123589,0.7138452268981181,15683234,0.28615477310188187,2010
2102,Driven,54744738,32720065,0.5976842011738187,22024673,0.40231579882618124,2001
2103,The Punisher,54700105,33810189,0.6181009890200394,20889916,0.38189901097996065,2004
2104,Open Water,54683487,30610863,0.5597825720221536,24072624,0.4402174279778464,2004
2105,Go Brother!,54663060,0,0.0,54663060,1.0,2018
2106,"Good Night, and Good Luck.",54641191,31558003,0.5775496914040545,23083188,0.4224503085959455,2005
2107,The Hot Chick,54639553,35081594,0.6420549231067099,19557959,0.3579450768932901,2002
2108,Early Man,54622814,8267544,0.15135697695838227,46355270,0.8486430230416178,2018
2109,Milk,54589558,31841299,0.5832855250449179,22748259,0.41671447495508207,2008
2110,The Age of Shadows,54491162,541719,0.009941410315309481,53949443,0.9900585896846905,2016
2111,No Escape,54418872,27288872,0.5014597141962075,27130000,0.4985402858037925,2015
2112,No Good Deed,54323210,52543632,0.9672409270365282,1779578,0.03275907296347178,2014
2113,Upcoming,54300000,0,0.0,54300000,1.0,2021
2114,Domestic Disturbance,54249294,45246095,0.8340402549754841,9003199,0.1659597450245159,2001
2115,The Five-Year Engagement,54169363,28835528,0.5323217110749484,25333835,0.4676782889250516,2012
2116,Madea's Big Happy Family,54161287,53345287,0.9849338882955274,816000,0.015066111704472605,2011
2117,Nine,54004950,19676965,0.36435484154693226,34327985,0.6356451584530677,2009
2118,A Ghost of a Chance,53982636,0,0.0,53982636,1.0,2011
2119,"I, Tonya",53939297,30014539,0.5564503185868366,23924758,0.4435496814131634,2017
2120,Peppermint,53918723,35418723,0.6568909838610235,18500000,0.34310901613897643,2018
2121,Long Shot,53873809,30316271,0.5627274470234692,23557538,0.4372725529765308,2019
2122,1987: When the Day Comes,53834292,0,0.0,53834292,1.0,2017
2123,Stranger Than Fiction,53653224,40660952,0.7578473196689913,12992272,0.24215268033100862,2006
2124,Overheard 3,53493428,0,0.0,53493428,1.0,2014
2125,The Cat Returns,53452652,0,0.0,53452652,1.0,2002
2126,Bounce,53425292,36805288,0.6889113118932508,16620004,0.31108868810674917,2000
2127,Supercondriaque,53425036,0,0.0,53425036,1.0,2014
2128,A Madea Christmas,53396635,52543354,0.9840199480735069,853281,0.01598005192649312,2013
2129,Sinister 2,53329150,27740955,0.5201837081596088,25588195,0.4798162918403912,2015
2130,Æon Flux,53321673,25874337,0.48524990954428604,27447336,0.514750090455714,2005
2131,Little White Lies,53319615,206088,0.003865144187556493,53113527,0.9961348558124435,2010
2132,A Chinese Odyssey: Part Three,53306108,0,0.0,53306108,1.0,2016
2133,Radio,53293628,52333738,0.9819886535028165,959890,0.01801134649718349,2003
2134,3 Days to Kill,53260230,30697999,0.5763775147046868,22562231,0.4236224852953132,2014
2135,Pitch Black,53187659,39240659,0.7377775171492319,13947000,0.26222248285076805,2000
2136,Temptation: Confessions of a Marriage Counselor,53143144,51975354,0.9780255756038823,1167790,0.021974424396117777,2013
2137,Delivery Man,53120346,30664106,0.5772572716299702,22456240,0.4227427283700298,2013
2138,Big Fat Liar,52970014,48360547,0.91297969073597,4609467,0.08702030926403002,2002
2139,The Outlaws,52946454,0,0.0,52946454,1.0,2017
2140,Man in Love,52946097,0,0.0,52946097,1.0,2021
2141,Untraceable,52933513,28687835,0.5419597788644785,24245678,0.45804022113552145,2008
2142,Detective Conan: Sunflowers of Inferno,52920296,0,0.0,52920296,1.0,2015
2143,Pooh's Heffalump Movie,52858433,18098433,0.34239442928624086,34760000,0.6576055707137591,2005
2144,From Paris with Love,52830951,24077427,0.4557447205521627,28753524,0.5442552794478374,2010
2145,Prem Ratan Dhan Payo,52715771,4364639,0.08279569694617575,48351132,0.9172043030538243,2015
2146,Break Through the Darkness,52700000,0,0.0,52700000,1.0,2021
2147,Rurouni Kenshin Part II: Kyoto Inferno,52696176,0,0.0,52696176,1.0,2014
2148,Wild,52501541,37880356,0.7215094124570554,14621185,0.2784905875429447,2014
2149,Tunnel,52444295,568876,0.010847242774452398,51875419,0.9891527572255476,2016
2150,The Boy Next Door,52425855,35423380,0.6756853083273511,17002475,0.3243146916726489,2015
2151,The Night Before,52395996,43047372,0.8215775113808315,9348624,0.17842248861916854,2015
2152,Arthur et la vengeance de Maltazard,52377611,0,0.0,52377611,1.0,2009
2153,Dragonfly,52323400,30323400,0.5795380269630797,22000000,0.4204619730369204,2002
2154,Greenland,52300000,0,0.0,52300000,1.0,2020
2155,Hollywood Adventures,52265070,0,0.0,52265070,1.0,2015
2156,One Hour Photo,52223306,31597131,0.6050388881929459,20626175,0.3949611118070541,2002
2157,Tolo Tolo,52186426,0,0.0,52186426,1.0,2020
2158,Patriots Day,52185751,31886361,0.6110166163940038,20299390,0.3889833836059962,2016
2159,My Beloved Bodyguard,52165873,0,0.0,52165873,1.0,2016
2160,Elizabethtown,52164016,26850426,0.51473080600236,25313590,0.48526919399764007,2005
2161,Take Off,52141043,0,0.0,52141043,1.0,2009
2162,The Finest Hours,52099090,27569558,0.5291754232175648,24529532,0.47082457678243517,2016
2163,Teen Titans GO! To the Movies,52090236,29790236,0.5718967370391641,22300000,0.4281032629608359,2018
2164,Detective Dee: The Mystery of the Phantom Flame,51899269,459836,0.008860163329082727,51439433,0.9911398366709173,2010
2165,Conference of Animals,51883642,0,0.0,51883642,1.0,2010
2166,Hanging Up,51880044,36050230,0.6948766273212875,15829814,0.3051233726787125,2000
2167,Blue Crush,51843679,40390647,0.7790852767219703,11453032,0.22091472327802972,2002
2168,"Yo-kai Watch Movie: It's the Secret of Birth, Meow!",51838845,257343,0.004964288845555876,51581502,0.9950357111544441,2015
2169,Enough,51806184,40007742,0.7722580377663022,11798442,0.2277419622336978,2002
2170,Escape Room: Tournament of Champions,51788958,25188958,0.4863769995140663,26600000,0.5136230004859337,2021
2171,The Texas Chainsaw Massacre: The Beginning,51764406,39517763,0.7634157532880799,12246643,0.23658424671192016,2006
2172,Slender Man,51738549,30569484,0.5908454061979975,21169065,0.4091545938020025,2018
2173,I Can Do Bad All by Myself,51733921,51733921,1.0,0,0.0,2009
2174,Doubt,51699984,33446470,0.6469338559176343,18253514,0.3530661440823657,2008
2175,Master,51636415,597251,0.011566469128424194,51039164,0.9884335308715758,2016
2176,College Road Trip,51549674,45610425,0.8847859057265813,5939249,0.11521409427341868,2008
2177,Daybreakers,51416464,30101577,0.5854462687282423,21314887,0.4145537312717576,2010
2178,Breaking In,51411620,46840590,0.9110895552406246,4571030,0.08891044475937541,2018
2179,Cry Me a Sad River,51400614,0,0.0,51400614,1.0,2018
2180,I Spy,51386477,33561137,0.6531122380699498,17825340,0.3468877619300502,2002
2181,Hot Pursuit,51380201,34580201,0.6730258022929883,16800000,0.3269741977070117,2015
2182,Meet Dave,51339567,11803254,0.22990560087894782,39536313,0.7700943991210522,2008
2183,Simmba,51329025,5102129,0.09940046591572702,46226896,0.900599534084273,2018
2184,Defiance,51262751,28644813,0.5587841549900433,22617938,0.44121584500995664,2008
2185,Once Upon a Deadpool 2018 Re-release,51247568,6100309,0.11903606820912946,45147259,0.8809639317908705,2018
2186,The 100 Year-Old Man Who Climbed Out the Window and Disappeared,51167572,944193,0.018452956884489263,50223379,0.9815470431155108,2013
2187,Hollywood Homicide,51142659,30940691,0.6049879221180111,20201968,0.3950120778819889,2003
2188,Doomsday: The Sinking of Japan,51127401,0,0.0,51127401,1.0,2006
2189,Sseo-ni,51116421,0,0.0,51116421,1.0,2011
2190,Magic in the Moonlight,51029361,10539326,0.20653454782629946,40490035,0.7934654521737006,2014
2191,Talk to Her 2002 Re-release,51001550,9285469,0.1820624863361996,41716081,0.8179375136638004,2002
2192,Red Dawn,50950296,44806783,0.8794214463444923,6143513,0.12057855365550771,2012
2193,Doraemon the Movie: Nobita and the Birth of Japan,50939840,0,0.0,50939840,1.0,2016
2194,Just Friends,50912434,32619671,0.6407014640077903,18292763,0.3592985359922097,2005
2195,Unleashed,50871113,24537621,0.4823488135594753,26333492,0.5176511864405247,2005
2196,Vanguard,50866390,793525,0.015600183146474518,50072865,0.9843998168535255,2020
2197,Team America: World Police,50826898,32786074,0.64505360921298,18040824,0.3549463907870199,2004
2198,Coco Before Chanel,50812934,6113834,0.12032042865306695,44699100,0.8796795713469331,2009
2199,The Skulls,50802120,35046120,0.6898554627247839,15756000,0.31014453727521607,2000
2200,What a Girl Wants,50732139,36105433,0.7116875754046168,14626706,0.2883124245953832,2003
2201,Pokémon: Arceus and the Jewel of Life,50673078,0,0.0,50673078,1.0,2009
2202,Sea Monsters: A Prehistoric Adventure,50652463,23746066,0.46880377761689496,26906397,0.531196222383105,2007
2203,Diary of a Mad Black Woman,50652203,50633099,0.9996228397015624,19104,0.0003771602984375625,2005
2204,Fever Pitch,50605163,42071069,0.8313592231685925,8534094,0.1686407768314075,2005
2205,The Jungle Book 2 2003 Re-release,50600160,0,0.0,50600160,1.0,2003
2206,War of the Arrows,50587661,251200,0.004965637766885486,50336461,0.9950343622331145,2011
2207,You Got Served,50576805,40363810,0.7980695894096118,10212995,0.20193041059038822,2004
2208,Kingdom,50574061,0,0.0,50574061,1.0,2019
2209,The Himalayas,50544493,696717,0.013784231647154914,49847776,0.9862157683528451,2015
2210,Alpha and Omega,50507267,25107267,0.49710207048027366,25400000,0.5028979295197263,2010
2211,Dragon Ball Z: Battle of Gods,50461371,2553002,0.05059319533747904,47908369,0.9494068046625209,2013
2212,Kokowääh,50447784,0,0.0,50447784,1.0,2011
2213,About Last Night,50445860,48637684,0.9641561071612219,1808176,0.03584389283877805,2014
2214,Breakthrough,50444358,40713082,0.8070889117074302,9731276,0.1929110882925698,2019
2215,Just Mercy,50401502,36001502,0.7142942287711981,14400000,0.28570577122880186,2019
2216,Red Tails,50365498,49876377,0.9902885701636466,489121,0.009711429836353449,2012
2217,"Monsters, Inc. 2012 3D Release",50207820,34043006,0.6780419066193274,16164814,0.32195809338067255,2012
2218,HOUBA! On the Trail of the Marsupilami,50146474,0,0.0,50146474,1.0,2012
2219,The Closet,50104745,6678894,0.13329863269436856,43425851,0.8667013673056314,2001
2220,National Security,50097949,36381186,0.7262011065562783,13716763,0.2737988934437216,2003
2221,The Replacements,50054511,44737059,0.8937667775837427,5317452,0.10623322241625735,2000
2222,Uncut Gems,50023780,50023780,1.0,0,0.0,2019
2223,The Women,50007546,26902075,0.5379603110298594,23105471,0.46203968897014064,2008
2224,Dearest 2014 Re-release,50000583,0,0.0,50000583,1.0,2014
2225,Family is Family,49954866,0,0.0,49954866,1.0,2018
2226,Drillbit Taylor,49944325,32862104,0.6579747348672748,17082221,0.3420252651327253,2008
2227,21 Bridges,49939757,28539757,0.5714836978481894,21400000,0.42851630215181064,2019
2228,Winnie the Pooh,49871429,26692846,0.535233229430823,23178583,0.464766770569177,2011
2229,The Wailing,49851770,786633,0.015779439727014708,49065137,0.9842205602729853,2016
2230,The Switch,49830607,27779426,0.5574771746208108,22051181,0.44252282537918913,2010
2231,Space Battleship Yamato,49827298,0,0.0,49827298,1.0,2010
2232,Notes on a Scandal,49814392,17510118,0.35150721100841703,32304274,0.648492788991583,2006
2233,An Inconvenient Truth,49782012,24146161,0.4850378686984367,25635851,0.5149621313015633,2006
2234,She's Out of My League,49779728,32010860,0.6430501187149917,17768868,0.3569498812850082,2010
2235,This Christmas,49778552,49121934,0.9868092185566185,656618,0.01319078144338148,2007
2236,Raising Helen,49718611,37486512,0.7539734366271817,12232099,0.24602656337281828,2004
2237,The Boy and the Beast,49714378,490643,0.009869237426645467,49223735,0.9901307625733545,2015
2238,Demain tout commence,49619118,0,0.0,49619118,1.0,2016
2239,Song of Youth,49615508,0,0.0,49615508,1.0,2019
2240,Surprise,49567466,0,0.0,49567466,1.0,2015
2241,Death Wish,49562710,34017028,0.6863431801852643,15545682,0.3136568198147357,2018
2242,CJ7,49529913,207378,0.004186924374367466,49322535,0.9958130756256325,2008
2243,The Grudge,49511319,21221803,0.4286252806151256,28289516,0.5713747193848744,2019
2244,Tad: The Lost Explorer,49490859,0,0.0,49490859,1.0,2012
2245,The Black Dahlia,49332692,22545080,0.45700080587534125,26787612,0.5429991941246588,2006
2246,Capote,49327405,28750530,0.5828510540945748,20576875,0.4171489459054252,2005
2247,May 18,49282156,0,0.0,49282156,1.0,2007
2248,One Piece: Strong World,49271461,0,0.0,49271461,1.0,2009
2249,Entourage,49263404,32363404,0.6569461582476112,16900000,0.34305384175238884,2015
2250,A Turtle's Tale 2: Sammy's Escape from Paradise,49261830,0,0.0,49261830,1.0,2012
2251,The Hurt Locker,49230772,17017811,0.3456742664933225,32212961,0.6543257335066774,2008
2252,The New Mutants,49169594,23852659,0.4851099441659006,25316935,0.5148900558340994,2020
2253,Death at a Funeral,49050886,42739347,0.8713267075338863,6311539,0.12867329246611367,2010
2254,Little,48987096,40860481,0.8341070268790786,8126615,0.16589297312092147,2019
2255,Whiplash,48982041,13092000,0.2672816349159481,35890041,0.732718365084052,2014
2256,Never Gone,48980792,96421,0.0019685471806989156,48884371,0.9980314528193011,2016
2257,The Berlin File,48972848,665210,0.013583241064518036,48307638,0.986416758935482,2013
2258,Trouble with the Curve,48963137,35763137,0.7304094302617906,13200000,0.2695905697382094,2012
2259,Luck-Key,48913975,466505,0.00953725392385305,48447470,0.9904627460761469,2016
2260,Florence Foster Jenkins,48902953,27383770,0.559961481262696,21519183,0.44003851873730404,2016
2261,Push,48858618,31811527,0.6510934672773594,17047091,0.34890653272264066,2009
2262,The Woman in Black 2: Angel of Death,48854305,26501323,0.5424562482262311,22352982,0.457543751773769,2015
2263,Bleeding Steel,48825526,0,0.0,48825526,1.0,2017
2264,Fantasy Island,48811343,27309289,0.5594865316449088,21502054,0.44051346835509114,2020
2265,Isn't It Romantic,48791187,48791187,1.0,0,0.0,2019
2266,Luca,48787355,0,0.0,48787355,1.0,2021
2267,Mother's Day,48782670,32492859,0.6660738126879894,16289811,0.33392618731201057,2016
2268,How Do You Know,48668907,30212620,0.6207786831950017,18456287,0.3792213168049983,2010
2269,Concussion,48623572,34542474,0.7104059323325732,14081098,0.28959406766742685,2015
2270,The Last King of Scotland,48618191,17606684,0.36214189869795854,31011507,0.6378581013020415,2006
2271,Shutter,48555306,25928550,0.534000341795807,22626756,0.465999658204193,2008
2272,Fat Albert,48551322,48116322,0.9910404087452037,435000,0.008959591254796317,2004
2273,Her,48517427,25568251,0.5269910747740189,22949176,0.47300892522598115,2013
2274,The Legend of Hei,48507082,0,0.0,48507082,1.0,2019
2275,Logan Lucky,48453605,27780977,0.5733521169374292,20672628,0.4266478830625709,2017
2276,Homefront,48449416,20158898,0.4160813414138986,28290518,0.5839186585861015,2013
2277,Mr. Brooks,48443734,28549298,0.5893290141507259,19894436,0.41067098584927414,2007
2278,9,48428063,31749894,0.6556094139053218,16678169,0.3443905860946782,2009
2279,Chef,48428048,31424003,0.6488802315550691,17004045,0.3511197684449309,2014
2280,20th Century Boys 3: Redemption,48397818,0,0.0,48397818,1.0,2009
2281,Boo 2! A Madea Halloween,48333932,47319572,0.979013501322425,1014360,0.020986498677575,2017
2282,The Last Stand,48330757,12050299,0.24932982117370933,36280458,0.7506701788262907,2013
2283,Secondhand Lions,48249017,42070939,0.8719543239606311,6178078,0.12804567603936884,2003
2284,Charlie St. Cloud,48190704,31162545,0.6466505448851713,17028159,0.3533494551148288,2010
2285,Arthur,48147945,33035397,0.6861226787560715,15112548,0.3138773212439285,2011
2286,Boyhood,48137666,25352281,0.5266620321807874,22785385,0.4733379678192125,2014
2287,Suite Dreams,48090431,0,0.0,48090431,1.0,2006
2288,21 & Over,48065672,25682380,0.5343185465086184,22383292,0.4656814534913815,2013
2289,Sky Hunter,48065601,0,0.0,48065601,1.0,2017
2290,Heartbreaker,48023509,504030,0.010495484617752526,47519479,0.9895045153822475,2010
2291,Countdown,48021766,25621766,0.5335448513076341,22400000,0.4664551486923659,2019
2292,After We Collided,47990414,2386483,0.04972832699463689,45603931,0.9502716730053631,2020
2293,Death Note: The Last Name,47917637,0,0.0,47917637,1.0,2006
2294,"From Today, It's My Turn: The Movie",47866854,0,0.0,47866854,1.0,2020
2295,Midsommar,47863365,27426361,0.5730136399728686,20437004,0.4269863600271314,2019
2296,Queen & Slim,47860909,43808310,0.9153254903704399,4052599,0.08467450962956011,2019
2297,The Nanny Diaries,47817020,25930652,0.5422891681664813,21886368,0.4577108318335187,2007
2298,Phantom Thread,47756590,21198205,0.4438802058522185,26558385,0.5561197941477815,2017
2299,Book of Shadows: Blair Witch 2,47737094,26437094,0.5538061030694496,21300000,0.4461938969305505,2000
2300,The Fourth Kind,47709193,25486040,0.5341955794557246,22223153,0.4658044205442754,2009
2301,Scott Pilgrim vs. the World,47664559,31524275,0.6613776705665104,16140284,0.3386223294334896,2010
2302,"Yo-kai Watch Movie: It's the Secret of Birth, Meow! 2016 Re-release",47642462,0,0.0,47642462,1.0,2016
2303,Man on a Ledge,47636031,18620000,0.3908805920459662,29016031,0.6091194079540337,2012
2304,Inside Men,47616503,0,0.0,47616503,1.0,2015
2305,The Dead End,47600000,0,0.0,47600000,1.0,2015
2306,Coming Home,47587984,377607,0.007934923236084135,47210377,0.9920650767639159,2014
2307,47 Meters Down: Uncaged,47582563,22260900,0.46783734621441053,25321663,0.5321626537855895,2019
2308,Boonie Bears Winter,47581416,0,0.0,47581416,1.0,2015
2309,A Walk to Remember,47494916,41281092,0.8691686495455639,6213824,0.130831350454436,2002
2310,Darkness Falls,47488536,32551396,0.685457980848262,14937140,0.314542019151738,2003
2311,Beauty and the Beast,47430624,0,0.0,47430624,1.0,2014
2312,The Magic Tuche,47427990,0,0.0,47427990,1.0,2018
2313,Crazy Heart,47405566,39464306,0.8324825401304142,7941260,0.16751745986958577,2009
2314,Nightcrawler,47398992,32381217,0.683162565988745,15017775,0.3168374340112549,2014
2315,Almost Famous,47383689,32534850,0.6866255179076496,14848839,0.31337448209235036,2000
2316,Rough Night,47347283,22105643,0.466883031070653,25241640,0.533116968929347,2017
2317,Texas Chainsaw,47340586,34341945,0.7254228961170865,12998641,0.2745771038829135,2013
2318,Broken Flowers,47329961,13744960,0.29040716936149596,33585001,0.709592830638504,2005
2319,A Monster Calls,47309313,3740823,0.07907159843982516,43568490,0.9209284015601749,2016
2320,Tiny Times 2.0,47289937,43788,0.0009259475224084143,47246149,0.9990740524775916,2013
2321,Golden Job,47287851,285795,0.006043729921243407,47002056,0.9939562700787566,2018
2322,Mortdecai,47275695,7696134,0.16279261468287246,39579561,0.8372073853171276,2015
2323,The Watcher,47267829,28946615,0.612395695177792,18321214,0.3876043048222079,2000
2324,Deck the Halls,47232776,35093569,0.7429918791984617,12139207,0.25700812080153834,2006
2325,Trolls World Tour,47217253,0,0.0,47217253,1.0,2020
2326,Switch,47164301,0,0.0,47164301,1.0,2013
2327,High Fidelity,47126295,27287137,0.5790214783487647,19839158,0.4209785216512353,2000
2328,Don't Breathe 2,47123535,32523535,0.6901760447300909,14600000,0.3098239552699092,2021
2329,Soul Surfer,47120948,43853424,0.9306566582658736,3267524,0.0693433417341264,2011
2330,The Wedding Date,47096206,31726995,0.6736635006225342,15369211,0.3263364993774658,2005
2331,Land of the Dead,47074133,20700082,0.4397336855890686,26374051,0.5602663144109313,2005
2332,Dracula 2000,47053625,33022767,0.7018113269700262,14030858,0.29818867302997376,2000
2333,The Place Beyond the Pines,47052899,21403519,0.45488204669387106,25649380,0.5451179533061289,2013
2334,Son of Bigfoot,47046281,289308,0.006149434000957483,46756973,0.9938505659990425,2017
2335,StreetDance 2,46960833,0,0.0,46960833,1.0,2010
2336,Parker,46922566,17616641,0.3754406994706982,29305925,0.6245593005293019,2013
2337,Death at a Funeral,46789413,8580428,0.18338396337650142,38208985,0.8166160366234986,2007
2338,Hachi: A Dog's Tale,46748131,0,0.0,46748131,1.0,2009
2339,Mary Queen of Scots,46712809,16468499,0.35254782044899075,30244310,0.6474521795510092,2018
2340,Uncle Drew,46664414,42469946,0.9101142039413588,4194468,0.08988579605864118,2018
2341,Be with You,46616207,0,0.0,46616207,1.0,2004
2342,Three Seconds,46596415,0,0.0,46596415,1.0,2017
2343,Get Rich or Die Tryin',46563961,30985352,0.6654363446443055,15578609,0.3345636553556945,2005
2344,Torque,46546197,21215059,0.45578501289804624,25331138,0.5442149871019538,2003
2345,The Big Wedding,46522137,21819348,0.4690100112984922,24702789,0.5309899887015078,2013
2346,Badges of Fury,46495296,0,0.0,46495296,1.0,2013
2347,Fantastic Mr. Fox,46471023,21002919,0.45195731972588593,25468104,0.5480426802741141,2009
2348,Zweiohrküken,46439905,0,0.0,46439905,1.0,2009
2349,Risen,46432579,36880033,0.7942706133122608,9552546,0.20572938668773924,2016
2350,The Nativity Story,46432264,37629831,0.8104242127844552,8802433,0.18957578721554477,2006
2351,Acrimony,46403669,43549096,0.9384838944523978,2854573,0.061516105547602284,2018
2352,A Werewolf Boy,46282588,342922,0.007409309090494248,45939666,0.9925906909095058,2012
2353,The Thousand Faces of Dunjia,46263237,124187,0.002684356047113608,46139050,0.9973156439528864,2017
2354,The Fog,46201432,29550869,0.6396093740124765,16650563,0.3603906259875235,2005
2355,The Battleship Island,46183383,1104957,0.023925423566307388,45078426,0.9760745764336927,2017
2356,Doraemon: Nobita and the Island of Miracles ~Animal Adventure~,46180706,0,0.0,46180706,1.0,2012
2357,Hanson and the Beast,46154323,0,0.0,46154323,1.0,2017
2358,Eddie the Eagle,46152800,15789389,0.342111182853478,30363411,0.657888817146522,2016
2359,Napoleon Dynamite,46118097,44540956,0.9658021231882139,1577141,0.03419787681178606,2004
2360,Into the Blue,46117696,18801234,0.4076793862382024,27316462,0.5923206137617977,2005
2361,The World's End,46089287,26004851,0.5642276696534707,20084436,0.43577233034652935,2013
2362,The Hunted,46061847,34244097,0.7434373398009854,11817750,0.2565626601990146,2003
2363,Gekijouban Tenpesuto 3D 2012 Re-release,46008255,0,0.0,46008255,1.0,2012
2364,Let's Get Married,45972724,462918,0.010069405502271303,45509806,0.9899305944977287,2015
2365,Asterix: The Secret of the Magic Potion,45972321,1271953,0.027667800370575157,44700368,0.9723321996294249,2018
2366,Welcome to the South,45896492,0,0.0,45896492,1.0,2010
2367,Eight Legged Freaks,45867333,17322606,0.37766760932012333,28544727,0.6223323906798767,2002
2368,One Missed Call,45847751,26890041,0.5865073076321672,18957710,0.4134926923678328,2008
2369,Gintama Live Action the Movie,45746967,0,0.0,45746967,1.0,2017
2370,Somewhere Only We Know,45737711,482341,0.010545805407708313,45255370,0.9894541945922917,2015
2371,Chasing the Dragon II: Wild Wild Bunch,45733356,196634,0.004299575128490461,45536722,0.9957004248715096,2019
2372,"McFarland, USA",45710059,44482410,0.9731426949153577,1227649,0.026857305084642312,2015
2373,Judy,45701880,24313888,0.5320106743967644,21387992,0.4679893256032356,2019
2374,Guilty of Mind,45698503,0,0.0,45698503,1.0,2017
2375,Earth to Echo,45681062,38934842,0.8523191076424624,6746220,0.14768089235753756,2014
2376,That Awkward Moment,45640143,26068955,0.5711847791537376,19571188,0.42881522084626245,2014
2377,The Debt,45636368,31177548,0.6831732972264576,14458820,0.31682670277354236,2011
2378,Bajrangi Bhaijaan 2018 Re-release,45579004,0,0.0,45579004,1.0,2018
2379,Hero,45565534,88675,0.0019460981188105905,45476859,0.9980539018811894,2015
2380,If You Are the One,45521453,0,0.0,45521453,1.0,2008
2381,Machete,45491656,26593646,0.5845829397813085,18898010,0.4154170602186915,2010
2382,Queen of the Damned,45479110,30336800,0.6670491133181806,15142310,0.33295088668181944,2002
2383,Love on the Cloud,45386560,271734,0.005987102789900799,45114826,0.9940128972100992,2014
2384,Good Boy,45312217,37667746,0.8312933794433408,7644471,0.16870662055665914,2003
2385,The Last House on the Left,45289053,32752215,0.7231817145746015,12536838,0.2768182854253985,2009
2386,The Spy Next Door,45236543,24307086,0.5373329699398117,20929457,0.4626670300601883,2009
2387,Tanhaji: The Unsung Warrior,45221814,0,0.0,45221814,1.0,2020
2388,Confessions,45203103,0,0.0,45203103,1.0,2010
2389,Blair Witch,45173154,20777061,0.4599426686035693,24396093,0.5400573313964308,2016
2390,Flatliners,45158254,16883115,0.3738655396198445,28275139,0.6261344603801555,2017
2391,Boonie Bears: The Big Top Secret,45150390,0,0.0,45150390,1.0,2016
2392,Deuce Bigalow: European Gigolo,45109561,22400154,0.49657220117925777,22709407,0.5034277988207423,2005
2393,Love Will Tear Us Apart,44972521,0,0.0,44972521,1.0,2021
2394,Monster's Ball,44909486,31273922,0.6963767521186949,13635564,0.30362324788130507,2001
2395,Grudge Match,44907260,29807260,0.6637514735924659,15100000,0.3362485264075341,2013
2396,Child's Play,44907074,29208403,0.6504187513976083,15698671,0.3495812486023917,2019
2397,Nodame Cantabile: The Movie II,44879450,0,0.0,44879450,1.0,2009
2398,Avatar 2010 Special Edition,44838548,10741486,0.239559184655132,34097062,0.760440815344868,2010
2399,Still Alice,44779195,18754371,0.41881885103115407,26024824,0.5811811489688459,2015
2400,The Wrestler,44734660,26238243,0.5865305112411718,18496417,0.41346948875882816,2008
2401,The Man from Nowhere,44723232,528175,0.011809857570222116,44195057,0.9881901424297779,2010
2402,The White Storm,44670277,0,0.0,44670277,1.0,2013
2403,Lakeview Terrace,44655002,39263506,0.8792633353817787,5391496,0.12073666461822127,2008
2404,Uptown Girls,44617342,37182494,0.8333641658886807,7434848,0.16663583411131933,2003
2405,The Gift,44567606,12008642,0.2694477688570483,32558964,0.7305522311429516,2000
2406,Bad Genius,44560421,0,0.0,44560421,1.0,2017
2407,Mother!,44516999,17800004,0.3998473482006278,26716995,0.6001526517993722,2017
2408,Recess: School's Out,44460850,36706141,0.8255834290167642,7754709,0.17441657098323582,2001
2409,Oculus,44446287,27695246,0.6231172021185931,16751041,0.37688279788140683,2014
2410,Notorious,44420167,36843682,0.8294359181495198,7576485,0.17056408185048022,2009
2411,Detective Conan: The Eleventh Striker,44369456,0,0.0,44369456,1.0,2012
2412,The Sisterhood of the Traveling Pants 2,44352417,44089964,0.9940825547342775,262453,0.005917445265722497,2008
2413,A Man Apart,44350926,26736098,0.6028306601760693,17614828,0.3971693398239306,2003
2414,Dark Water 2005 Re-release,44347079,25473352,0.5744087902610227,18873727,0.4255912097389774,2005
2415,Unhinged,44331465,20831465,0.4699024722056896,23500000,0.5300975277943104,2020
2416,House at the End of the Street,44287131,31611916,0.7137946235442526,12675215,0.2862053764557474,2012
2417,The Girl Who Kicked the Hornet's Nest,44276335,5190196,0.11722280084835386,39086139,0.8827771991516461,2009
2418,The Good the Bad the Weird,44261209,128486,0.0029029030815674287,44132723,0.9970970969184326,2008
2419,Hardball,44102389,40222729,0.912030615847137,3879660,0.08796938415286301,2001
2420,Tarzan,44095996,0,0.0,44095996,1.0,2013
2421,The Great Hypnotist,44077818,0,0.0,44077818,1.0,2014
2422,Winchester,44019588,25091816,0.5700147852360635,18927772,0.4299852147639365,2018
2423,Semi-Pro,44004502,33479698,0.7608243811053697,10524804,0.23917561889463038,2008
2424,Kick,43996483,2472695,0.056202105972879696,41523788,0.9437978940271203,2014
2425,Wind River,43980821,33800859,0.7685363354176585,10179962,0.23146366458234147,2017
2426,Max,43967255,42656255,0.9701823550276223,1311000,0.029817644972377738,2015
2427,The End of Endless Love,43950000,0,0.0,43950000,1.0,2020
2428,Timeline,43935763,19481943,0.4434187930228957,24453820,0.5565812069771042,2003
2429,The Transporter,43928932,25296447,0.5758493514023969,18632485,0.42415064859760304,2002
2430,Battle of Memories,43892362,594552,0.01354568250393998,43297810,0.98645431749606,2017
2431,In the Heights,43879041,29879041,0.6809410670575048,14000000,0.31905893294249527,2021
2432,Son of a Rich,43833888,0,0.0,43833888,1.0,2019
2433,Of Gods and Men,43803417,3951596,0.09021204898238874,39851821,0.9097879510176112,2010
2434,Café Society,43763247,11103205,0.25371072215002693,32660042,0.746289277849973,2016
2435,Richard Jewell,43745542,22345542,0.5108072955182497,21400000,0.4891927044817504,2019
2436,The DUFF,43709744,34030343,0.7785527867653491,9679401,0.22144721323465083,2015
2437,The Sea Inside,43685449,2104923,0.04818361830274424,41580526,0.9518163816972558,2004
2438,"Welcome Home, Roscoe Jenkins",43655418,42436517,0.9720790441177313,1218901,0.027920955882268724,2008
2439,Boy,43551154,256211,0.005882989920313018,43294943,0.994117010079687,2010
2440,We Are Marshall,43545364,43545364,1.0,0,0.0,2006
2441,League of Gods,43498766,181633,0.004175589716728976,43317133,0.9958244102832711,2016
2442,Harold & Kumar Escape from Guantanamo Bay,43495888,38108728,0.8761455335731966,5387160,0.12385446642680338,2008
2443,Brothers,43474578,28544157,0.6565712265223138,14930421,0.3434287734776862,2009
2444,Last Holiday,43451846,38399961,0.8837360097428312,5051885,0.11626399025716883,2006
2445,Secretly Greatly,43447199,0,0.0,43447199,1.0,2013
2446,The Master of Disguise,43411001,40388794,0.9303815408449116,3022207,0.06961845915508837,2002
2447,In the Bedroom,43368779,35930604,0.8284900988335411,7438175,0.17150990116645895,2001
2448,Harriet,43347017,43082155,0.9938897294824232,264862,0.006110270517576792,2019
2449,The Duchess,43343384,13848978,0.31951769155818566,29494406,0.6804823084418143,2008
2450,Pokémon: Giratina and the Sky Warrior,43338599,0,0.0,43338599,1.0,2008
2451,Orange County,43325009,41076018,0.94809023582661,2248991,0.051909764173390015,2002
2452,Beastly,43202283,27865571,0.6450022791619601,15336712,0.35499772083804,2011
2453,The Snowman,43155261,6700035,0.1552541878961177,36455226,0.8447458121038823,2017
2454,A Shaun the Sheep Movie: Farmageddon,43100248,0,0.0,43100248,1.0,2019
2455,Freedom Writers,43095175,36605602,0.8494130027317444,6489573,0.15058699726825567,2007
2456,Annihilation,43070915,32732301,0.7599629819798349,10338614,0.2400370180201651,2018
2457,See Spot Run,43057552,33357476,0.7747183583497733,9700076,0.22528164165022665,2001
2458,When in Rome,43053376,32680633,0.7590724824924299,10372743,0.24092751750757013,2010
2459,Gifted,43046590,24801212,0.5761481223019059,18245378,0.42385187769809407,2017
2460,The Possession of Hannah Grace,43016528,14837422,0.3449237465190124,28179106,0.6550762534809876,2018
2461,Legend,42972994,1872994,0.04358537364187378,41100000,0.9564146263581262,2015
2462,"The Chef, The Actor, The Scoundrel",42970000,0,0.0,42970000,1.0,2013
2463,The Gallows,42964410,22764410,0.5298434215668271,20200000,0.47015657843317293,2015
2464,Glory Road,42938449,42647449,0.9932228572112607,291000,0.006777142788739295,2006
2465,Crank,42931041,27838408,0.6484447465413196,15092633,0.3515552534586804,2006
2466,A Lot Like Love,42886719,21845719,0.5093819137808141,21041000,0.49061808621918596,2005
2467,The Warlords,42883181,129078,0.0030099912597435345,42754103,0.9969900087402565,2007
2468,Asterix and Obelix: Mansion of the Gods,42830578,0,0.0,42830578,1.0,2014
2469,Detective Conan: Quarter of Silence,42808575,0,0.0,42808575,1.0,2011
2470,Basic,42792561,26793311,0.6261207643076094,15999250,0.37387923569239057,2003
2471,Zack and Miri Make a Porno,42782463,31457946,0.735300022347942,11324517,0.26469997765205805,2008
2472,Shaolin Soccer,42776760,489600,0.01144546711812676,42287160,0.9885545328818732,2001
2473,Doraemon: Nobita's Secret Gadget Museum,42770271,0,0.0,42770271,1.0,2013
2474,Shaolin,42741494,66099,0.001546483143523247,42675395,0.9984535168564768,2011
2475,Train to Busan Presents: Peninsula,42698327,1231407,0.02883970137752704,41466920,0.971160298622473,2020
2476,Spirit Untamed,42636215,17635215,0.41362055707806145,25001000,0.5863794429219386,2021
2477,Almost Christmas,42580920,42158780,0.9900861700498721,422140,0.009913829950127897,2016
2478,Oliver Twist,42580321,2080321,0.04885639542266485,40500000,0.9511436045773352,2005
2479,Pokémon: The Rise of Darkrai,42496749,0,0.0,42496749,1.0,2007
2480,Bangkok Dangerous,42487390,15298133,0.36006290336968216,27189257,0.6399370966303178,2008
2481,Thermae Romae II,42473163,0,0.0,42473163,1.0,2014
2482,Man of the Year,42472472,37327390,0.8788607830502543,5145082,0.1211392169497457,2006
2483,Love the Coopers,42426912,26302731,0.6199539339558816,16124181,0.3800460660441184,2015
2484,8 Women,42426583,3098776,0.0730385475540182,39327807,0.9269614524459818,2002
2485,My Name Is Khan,42345360,4018771,0.09490463654105195,38326589,0.905095363458948,2010
2486,Always: Sunset on Third Street 2,42304705,0,0.0,42304705,1.0,2007
2487,A Good Year,42269923,7459300,0.17646826562707482,34810623,0.8235317343729252,2006
2488,Loving Vincent,42187665,6735118,0.15964661708582353,35452547,0.8403533829141765,2017
2489,The Throne,42165755,0,0.0,42165755,1.0,2015
2490,Monster Hunter,42145959,15162470,0.3597609441037989,26983489,0.6402390558962011,2020
2491,Long Day's Journey Into Night,42140994,521365,0.01237191984602926,41619629,0.9876280801539707,2018
2492,Jobs,42128352,16131410,0.3829110144161348,25996942,0.6170889855838653,2013
2493,Going the Distance,42059111,17804299,0.4233161038520286,24254812,0.5766838961479713,2010
2494,Bang Bang,42045981,2546172,0.060556846087144456,39499809,0.9394431539128556,2014
2495,Detective Conan: The Sniper from Another Dimension,42028116,0,0.0,42028116,1.0,2014
2496,The Sisterhood of the Traveling Pants,42013878,39053061,0.9295276432230322,2960817,0.07047235677696784,2005
2497,200 Pounds Beauty,42013016,0,0.0,42013016,1.0,2006
2498,Mary and the Witch's Flower,41978431,2418404,0.05761063342267366,39560027,0.9423893665773263,2017
2499,Meet the Browns,41975388,41975388,1.0,0,0.0,2008
2500,Rurouni Kenshin: The Legend Ends,41900000,0,0.0,41900000,1.0,2014
2501,"As Above, So Below",41898409,21321100,0.5088761246280259,20577309,0.49112387537197416,2014
2502,Call Me by Your Name,41887595,18095701,0.4320062061333433,23791894,0.5679937938666567,2017
2503,The Guilt Trip,41863726,37134215,0.8870260377683534,4729511,0.11297396223164656,2012
2504,No Man's Land,41807712,0,0.0,41807712,1.0,2013
2505,The Informant!,41771168,33316821,0.7976032894268122,8454347,0.2023967105731877,2009
2506,Scandal Makers,41745790,0,0.0,41745790,1.0,2008
2507,Balls of Fury,41739111,32886940,0.7879166377070178,8852171,0.21208336229298225,2007
2508,Fly Me to the Moon 3D,41721414,13816982,0.33117242862382373,27904432,0.6688275713761763,2008
2509,Wimbledon,41682237,17001133,0.4078747740914193,24681104,0.5921252259085806,2004
2510,T2 Trainspotting,41681746,2402004,0.05762724047116452,39279742,0.9423727595288355,2017
2511,Overlord,41657844,21704844,0.5210265802522089,19953000,0.47897341974779106,2018
2512,Born to Be Wild,41644475,25978556,0.6238175892480335,15665919,0.3761824107519665,2011
2513,The Uninvited,41633384,28596818,0.6868722945989689,13036566,0.3131277054010311,2009
2514,Never Back Down,41627431,24850922,0.5969842818308918,16776509,0.40301571816910825,2008
2515,My Best Friend's Girl,41624687,19219250,0.4617271956903844,22405437,0.5382728043096155,2008
2516,Undercover Brother,41604473,39089928,0.9395607054078056,2514545,0.06043929459219445,2002
2517,Safe,41564670,17142080,0.4124194899177595,24422590,0.5875805100822405,2012
2518,Escape Captivity: The Movie,41550983,0,0.0,41550983,1.0,2008
2519,The Great Battle,41509280,472166,0.0113749503725432,41037114,0.9886250496274568,2018
2520,Gridiron Gang,41480851,38432823,0.9265196367355144,3048028,0.07348036326448558,2006
2521,Lupin III vs. Detective Conan: The Movie,41397727,0,0.0,41397727,1.0,2013
2522,The Lady in the Van,41387687,10021175,0.24212938017048405,31366512,0.757870619829516,2015
2523,Shark Night,41363927,18877153,0.45636752525938845,22486774,0.5436324747406115,2011
2524,Ricki and the Flash,41325328,26822144,0.6490485447568619,14503184,0.35095145524313803,2015
2525,Quarantine,41319906,31691811,0.7669865221861831,9628095,0.2330134778138169,2008
2526,Leatherheads,41319039,31373938,0.7593094795839758,9945101,0.2406905204160242,2008
2527,Pinocchio,41314585,3675719,0.08896904083630515,37638866,0.9110309591636948,2002
2528,This Is Where I Leave You,41296320,34296320,0.8304933708378858,7000000,0.1695066291621142,2014
2529,Toy Story 2009 Re-release,41258298,30702446,0.744152024884788,10555852,0.25584797511521196,2009
2530,Evangelion: 2.0 You Can (Not) Advance,41162041,133640,0.0032466806007019912,41028401,0.996753319399298,2009
2531,The Concert,41146351,657986,0.01599135728949573,40488365,0.9840086427105043,2009
2532,The Darkest Minds,41142379,12695691,0.30857940908084097,28446688,0.6914205909191591,2018
2533,50/50,41097853,35014192,0.8519713183070659,6083661,0.14802868169293418,2011
2534,Fist Fight,41087017,32187017,0.7833865622320549,8900000,0.21661343776794503,2017
2535,Whale Rider,41062976,20779666,0.5060438386151067,20283310,0.4939561613848933,2003
2536,Nodame Cantabile: The Movie II 2010 Re-release,41054604,0,0.0,41054604,1.0,2010
2537,"Lost, Found",41043552,0,0.0,41043552,1.0,2018
2538,Dredd,41037742,13414714,0.32688723468264896,27623028,0.6731127653173511,2012
2539,Fright Night,41002607,18302607,0.4463766657568871,22700000,0.5536233342431128,2011
2540,Twisted,40954603,25198598,0.6152812175959806,15756005,0.3847187824040194,2004
2541,Breach,40953935,33231264,0.8114303057813614,7722671,0.18856969421863856,2007
2542,La vérité si je mens! 3,40928635,0,0.0,40928635,1.0,2012
2543,Always: Sunset on Third Street '64,40923305,0,0.0,40923305,1.0,2012
2544,Drive Angry,40909909,10721033,0.262064454848824,30188876,0.737935545151176,2011
2545,Underwater,40882928,17291078,0.4229412824834855,23591850,0.5770587175165145,2020
2546,The Love Guru,40877556,32235793,0.7885939413794699,8641763,0.21140605862053005,2008
2547,Where the Heart Is,40863718,33772838,0.8264749184105078,7090880,0.17352508158949217,2000
2548,Gamer,40828540,20534907,0.5029547223584286,20293633,0.4970452776415713,2009
2549,Fighting with My Family,40812363,22958886,0.5625473340026893,17853477,0.43745266599731064,2019
2550,The War with Grandpa,40753513,21277892,0.5221118483699798,19475621,0.47788815163002024,2020
2551,30 Minutes or Less,40662632,37053924,0.9112524737700206,3608708,0.0887475262299794,2011
2552,The Circle,40656399,20497844,0.504172639588666,20158555,0.495827360411334,2017
2553,Ocho apellidos catalanes,40591862,0,0.0,40591862,1.0,2015
2554,Gantz,40568961,0,0.0,40568961,1.0,2011
2555,The Roommate,40492652,37300000,0.9211547813662587,3192652,0.07884521863374125,2011
2556,War,40481352,22486409,0.5554757410276218,17994943,0.4445242589723782,2007
2557,Holmes & Watson,40466970,30573626,0.7555205146320567,9893344,0.24447948536794328,2018
2558,Serenity,40445129,25514517,0.6308427647739732,14930612,0.36915723522602684,2005
2559,Bless the Child,40443010,29381494,0.7264912774790996,11061516,0.2735087225209004,2000
2560,The Ringer,40442443,35428675,0.8760270738342884,5013768,0.12397292616571161,2005
2561,The Witch,40423945,25138705,0.6218765882449128,15285240,0.37812341175508724,2016
2562,The Boy in the Striped Pajamas,40416563,9046156,0.22382299058927896,31370407,0.7761770094107211,2008
2563,The Art of War,40400425,30208599,0.7477297330411747,10191826,0.2522702669588253,2000
2564,Masquerade Hotel,40396244,0,0.0,40396244,1.0,2019
2565,Bad Education,40350837,5211842,0.12916316952731366,35138995,0.8708368304726863,2004
2566,Magnificent Desolation: Walking on the Moon,40339402,34137524,0.8462575622712504,6201878,0.15374243772874968,2005
2567,Spiral,40294273,23216862,0.5761826748927819,17077411,0.4238173251072181,2021
2568,Carol,40272135,12711491,0.3156398586764769,27560644,0.6843601413235231,2015
2569,Yolki 3,40267368,0,0.0,40267368,1.0,2013
2570,SP: The Motion Picture II,40255101,0,0.0,40255101,1.0,2011
2571,The Invasion,40170558,15074191,0.37525470768914887,25096367,0.6247452923108512,2007
2572,Bears and Lola,40163675,0,0.0,40163675,1.0,2014
2573,Crimson Rivers 2: Angels of the Apocalypse,40152148,152148,0.0037892866902164237,40000000,0.9962107133097836,2004
2574,Diary of a Wimpy Kid: The Long Haul,40140972,20738724,0.5166472799911273,19402248,0.48335272000887275,2017
2575,All About Steve,40105542,33862903,0.8443447292147305,6242639,0.15565527078526953,2009
2576,The Wild Life,40075446,8005586,0.19976286726790266,32069860,0.8002371327320974,2016
2577,Northern Limit Line,40034677,337907,0.008440357842777151,39696770,0.9915596421572228,2015
2578,Dancer in the Dark,40031879,4184036,0.10451760208407904,35847843,0.895482397915921,2000
2579,Om Shanti Om,39990809,3597372,0.0899549694030946,36393437,0.9100450305969054,2007
2580,Dream House,39984400,21302340,0.532766278848751,18682060,0.467233721151249,2011
2581,Black Knight,39976235,33426971,0.8361710651340728,6549264,0.16382893486592723,2001
2582,Love O2O,39969537,0,0.0,39969537,1.0,2016
2583,Brotherhood of Blades 2,39966092,14204,0.0003554012736596813,39951888,0.9996445987263404,2017
2584,The Secret Life of Bees,39952437,37770162,0.945378175554097,2182275,0.054621824445903015,2008
2585,Astro Boy,39886986,19551067,0.49016155294360925,20335919,0.5098384470563908,2009
2586,Monte Carlo,39782683,23186769,0.5828357277964384,16595914,0.41716427220356156,2011
2587,Eiga Kaibutsukun,39766344,0,0.0,39766344,1.0,2011
2588,The Last Wish,39756292,0,0.0,39756292,1.0,2019
2589,Midnight Runners,39730433,0,0.0,39730433,1.0,2017
2590,Memento,39723096,25544867,0.6430734150228371,14178229,0.3569265849771629,2001
2591,The Forest,39712000,26594261,0.6696782080983078,13117739,0.3303217919016922,2016
2592,SP: The Motion Picture I,39674739,0,0.0,39674739,1.0,2010
2593,Detective Conan: The Raven Chaser,39664359,0,0.0,39664359,1.0,2009
2594,The November Man,39661919,25018119,0.6307843803523475,14643800,0.3692156196476524,2014
2595,Intimate Strangers,39576060,0,0.0,39576060,1.0,2018
2596,Thugs of Hindostan,39570044,1449848,0.0366400401273246,38120196,0.9633599598726754,2018
2597,Tokyo Revengers,39563158,0,0.0,39563158,1.0,2021
2598,Recep Ivedik 4,39477906,0,0.0,39477906,1.0,2014
2599,Down with Love,39468111,20305251,0.5144723293192319,19162860,0.4855276706807681,2003
2600,The Legend of Bagger Vance,39459427,30919168,0.7835686007300613,8540259,0.2164313992699387,2000
2601,Agora,39457342,619423,0.01569854857430589,38837919,0.9843014514256941,2009
2602,Don Jon,39439355,24477704,0.6206415901071405,14961651,0.37935840989285957,2013
2603,Crocodile Dundee in Los Angeles,39438674,25635682,0.6500137910316153,13802992,0.34998620896838467,2001
2604,Halloween II,39421467,33392973,0.8470758584402757,6028494,0.1529241415597243,2009
2605,Sin City: A Dame to Kill For,39407616,13757804,0.3491153588179503,25649812,0.6508846411820497,2014
2606,Uri: The Surgical Strike,39346577,4186168,0.10639217739322025,35160409,0.8936078226067797,2019
2607,Thank You for Smoking,39323027,24793509,0.6305086584509376,14529518,0.3694913415490623,2006
2608,Cirque du Freak: The Vampire's Assistant,39291383,13869515,0.35299126528582614,25421868,0.6470087347141739,2009
2609,Otoko-tachi no Yamato,39287114,0,0.0,39287114,1.0,2005
2610,The Gambler,39280992,33680992,0.8574374089126874,5600000,0.14256259108731267,2014
2611,Dumb and Dumberer: When Harry Met Lloyd,39267515,26276465,0.6691654666713694,12991050,0.33083453332863055,2003
2612,Mars Needs Moms,39233678,21392758,0.5452651673391417,17840920,0.45473483266085835,2011
2613,Scoop,39220946,10525717,0.26836978893879815,28695229,0.7316302110612019,2006
2614,Absolutely Fabulous: The Movie,39219109,4772155,0.12167933238870877,34446954,0.8783206676112912,2016
2615,Tazza: The High Rollers,39212715,0,0.0,39212715,1.0,2006
2616,My Mom Is a Character 2,39195565,0,0.0,39195565,1.0,2016
2617,Sink or Swim,39193850,0,0.0,39193850,1.0,2018
2618,Samba,39178695,151530,0.0038676632797493638,39027165,0.9961323367202506,2014
2619,The Spirit,39164441,19806188,0.5057186441139297,19358253,0.49428135588607025,2008
2620,Show Dogs,39156854,17857020,0.4560381689499366,21299834,0.5439618310500635,2018
2621,Women Who Flirt,39156132,375495,0.009589685722787941,38780637,0.990410314277212,2014
2622,Admiral,39143985,0,0.0,39143985,1.0,2008
2623,Masterpiece Mystery: Sherlock: The Abominable Bride,39139204,0,0.0,39139204,1.0,2016
2624,Ex-Files 2: The Backup Strikes Back,39108291,0,0.0,39108291,1.0,2015
2625,Haunted Castle,39093166,13651656,0.3492082478047442,25441510,0.6507917521952559,2001
2626,Believer,39047153,365639,0.009364037372968011,38681514,0.990635962627032,2018
2627,The Crown Jewels,39000000,0,0.0,39000000,1.0,2011
2628,The Life of David Gale,38955598,19955598,0.512265220521066,19000000,0.48773477947893396,2003
2629,Forbidden Empire 2014 Re-release,38885962,0,0.0,38885962,1.0,2014
2630,The Spy Gone North,38844509,500803,0.012892504317663018,38343706,0.987107495682337,2018
2631,First Sunday,38810311,37931869,0.9773657572597138,878442,0.02263424274028621,2008
2632,The Wicker Man,38805380,23649127,0.6094290791637654,15156253,0.39057092083623457,2006
2633,Criminal,38803993,14708696,0.3790510940459143,24095297,0.6209489059540857,2015
2634,Clockstoppers,38793283,36989956,0.9535144524891075,1803327,0.046485547510892546,2002
2635,Dreamer,38741732,32751093,0.8453698714347618,5990639,0.15463012856523814,2005
2636,Antoine and Sebastian,38719881,0,0.0,38719881,1.0,2013
2637,Someone Like You,38689940,27343067,0.7067229103999645,11346873,0.29327708960003557,2001
2638,Jeon Woochi,38681926,0,0.0,38681926,1.0,2009
2639,On the Basis of Sex,38673750,24622687,0.6366769966708685,14051063,0.36332300332913153,2018
2640,"Crouching Tiger, Hidden Dragon: Sword of Destiny",38659039,0,0.0,38659039,1.0,2016
2641,Basic Instinct 2,38629478,5971336,0.15457977454419652,32658142,0.8454202254558034,2006
2642,Accepted,38623262,36323505,0.9404566864393794,2299757,0.05954331356062054,2006
2643,Head of State,38620484,38125247,0.987176830823767,495237,0.012823169176233006,2003
2644,The Best of Me,38609668,26766213,0.6932515710831805,11843455,0.30674842891681947,2014
2645,Taxi 5,38598227,0,0.0,38598227,1.0,2018
2646,Urban Legends: Final Cut,38574362,21468807,0.5565563728571843,17105555,0.44344362714281577,2000
2647,Always: Sunset on Third Street,38573583,0,0.0,38573583,1.0,2005
2648,Million Dollar Arm,38483455,36457627,0.9473584687237672,2025828,0.05264153127623286,2014
2649,What's the Worst That Could Happen?,38464131,32269834,0.8389591331206728,6194297,0.16104086687932714,2001
2650,Day Watch,38411815,0,0.0,38411815,1.0,2006
2651,Employee of the Month,38395414,28444855,0.7408399086411727,9950559,0.2591600913588274,2006
2652,Chernobyl Diaries,38390020,18119640,0.4719882927906784,20270380,0.5280117072093216,2012
2653,The Missing,38364277,27011180,0.7040711336746943,11353097,0.2959288663253057,2003
2654,Boruto: Naruto The Movie,38362448,919651,0.023972688082887723,37442797,0.9760273119171122,2015
2655,The Lazarus Effect,38356892,25801570,0.6726710287162996,12555322,0.3273289712837005,2015
2656,The Soloist,38332994,31720158,0.8274897076914994,6612836,0.1725102923085006,2009
2657,Ghajini,38316584,2430627,0.0634353782685847,35885957,0.9365646217314153,2008
2658,Van Wilder,38275483,21305259,0.5566293964206801,16970224,0.44337060357931996,2002
2659,Don't Be Afraid of the Dark,38269529,24046682,0.6283506128335157,14222847,0.3716493871664843,2011
2660,20th Century Boys 1: Beginning of the End,38231562,0,0.0,38231562,1.0,2008
2661,The Original Kings of Comedy,38182790,38182790,1.0,0,0.0,2000
2662,The Water Diviner,38176317,4196641,0.10992786444014492,33979676,0.8900721355598551,2014
2663,Just My Luck,38159905,17326650,0.45405380333100936,20833255,0.5459461966689907,2006
2664,Jumping the Broom,38158601,37295394,0.9773784421499101,863207,0.022621557850089943,2011
2665,Happily N'Ever After,38085778,15589393,0.40932321246004216,22496385,0.5906767875399578,2007
2666,One for the Money,38080789,26414527,0.6936444252770078,11666262,0.30635557472299224,2011
2667,The Producers,38075318,19398532,0.5094778722530958,18676786,0.4905221277469042,2005
2668,The Banger Sisters,38068353,30307416,0.7961315268879638,7760937,0.20386847311203612,2002
2669,But Always,38039248,430760,0.011324093473141214,37608488,0.9886759065268588,2014
2670,Overcomer,38026103,34746945,0.9137656046426845,3279158,0.08623439535731547,2019
2671,The Eagle,37989684,19490041,0.5130350913158425,18499643,0.48696490868415754,2011
2672,Kokkuri-san: Gekijô-ban,37982240,0,0.0,37982240,1.0,2010
2673,For Colored Girls,37981984,37729698,0.9933577456090761,252286,0.0066422543909238655,2010
2674,Chek dou,37938005,0,0.0,37938005,1.0,2015
2675,Killing Them Softly,37930465,15026056,0.39614742397700636,22904409,0.6038525760229937,2012
2676,Camping,37912041,0,0.0,37912041,1.0,2006
2677,The King,37886707,0,0.0,37886707,1.0,2017
2678,Hell or High Water,37879877,27007844,0.7129865812394269,10872033,0.28701341876057307,2016
2679,Amalfi: Rewards of the Goddess,37840539,0,0.0,37840539,1.0,2009
2680,Cold Eyes,37795598,0,0.0,37795598,1.0,2013
2681,Mission Milano,37749848,0,0.0,37749848,1.0,2016
2682,Bulletproof Monk,37713879,23358708,0.6193663611213261,14355171,0.3806336388786738,2003
2683,The Hills Have Eyes 2,37697773,20804166,0.5518672416007173,16893607,0.4481327583992826,2007
2684,The Handmaiden,37692886,2006788,0.05324049742436809,35686098,0.9467595025756319,2016
2685,Casanova,37691644,11304403,0.2999180136584119,26387241,0.700081986341588,2005
2686,The Yinyang Master,37690000,0,0.0,37690000,1.0,2021
2687,The Prince and Me,37666766,28176497,0.7480466201956387,9490269,0.2519533798043612,2004
2688,Halloween: Resurrection,37664855,30354442,0.8059089036716058,7310413,0.1940910963283942,2002
2689,Rurouni Kenshin Part I: Origins,37654579,0,0.0,37654579,1.0,2012
2690,The Covenant,37598767,23380495,0.6218420673209842,14218272,0.37815793267901576,2006
2691,Painted Skin,37579689,0,0.0,37579689,1.0,2008
2692,Pokémon the Movie: I Choose You!,37552144,2401722,0.06395698738266449,35150422,0.9360430126173355,2017
2693,Fat Buddies,37496410,0,0.0,37496410,1.0,2018
2694,Broken Embraces,37472507,5014305,0.13381290448488006,32458202,0.86618709551512,2009
2695,A Walk in the Woods,37461274,29504281,0.7875941699153104,7956993,0.21240583008468958,2015
2696,Sarileru Neekevvaru,37389889,821000,0.021957807898279665,36568889,0.9780421921017204,2020
2697,Nomadland,37379948,2143000,0.057330202813551265,35236948,0.9426697971864487,2021
2698,Pain and Glory,37359689,4567338,0.12225310547954508,32792351,0.877746894520455,2019
2699,Snowden,37357216,21587519,0.5778674460109662,15769697,0.4221325539890339,2016
2700,Natale in crociera,37350000,0,0.0,37350000,1.0,2007
2701,The Majestic,37317558,27807266,0.7451523489291555,9510292,0.25484765107084445,2001
2702,Becoming Jane,37311672,18670946,0.5004049671105599,18640726,0.49959503288944007,2007
2703,Home Again,37270721,27020284,0.7249734718037786,10250437,0.27502652819622136,2017
2704,Beauty Shop,37245453,36351350,0.9759943045933688,894103,0.024005695406631247,2005
2705,Pokémon: Lucario and the Mystery of Mew,37228626,0,0.0,37228626,1.0,2005
2706,"Like Father, Like Son",37170163,334616,0.009002274216553745,36835547,0.9909977257834462,2013
2707,The Family That Preys,37105289,37105289,1.0,0,0.0,2008
2708,A Witness Out of the Blue,37092694,0,0.0,37092694,1.0,2019
2709,Till The End Of The World,37013733,118660,0.003205837141582018,36895073,0.9967941628584179,2018
2710,Rurouni Kenshin: Final Chapter Part I - The Final,36964978,0,0.0,36964978,1.0,2021
2711,Snake Eyes,36964325,28264325,0.7646379313026818,8700000,0.2353620686973183,2021
2712,2.0,36945969,4152000,0.11238032490093845,32793969,0.8876196750990616,2018
2713,Devil's Due,36921560,15821461,0.42851550692874296,21100099,0.571484493071257,2014
2714,Ex Machina,36869414,25442958,0.6900830590906598,11426456,0.3099169409093402,2015
2715,The Adventurers,36796816,216556,0.0058851831093211975,36580260,0.9941148168906788,2017
2716,Titan A.E.,36754634,22753426,0.6190627826684385,14001208,0.3809372173315615,2000
2717,New Interpretation Records of the Three Kingdoms,36747486,0,0.0,36747486,1.0,2020
2718,The Adventures of Super Monkey,36745063,0,0.0,36745063,1.0,2007
2719,Negotiator: Mashita Masayoshi,36733286,0,0.0,36733286,1.0,2005
2720,Natale a Rio,36702844,0,0.0,36702844,1.0,2008
2721,Valentine,36684136,20384136,0.5556662422143457,16300000,0.44433375778565426,2001
2722,Sky of Love,36684020,0,0.0,36684020,1.0,2007
2723,Joy Ride,36642838,21974919,0.5997057051094132,14667919,0.4002942948905868,2001
2724,Return to Me,36609995,32722798,0.8938214277275919,3887197,0.10617857227240812,2000
2725,Burnt,36606743,13651946,0.3729352813496683,22954797,0.6270647186503318,2015
2726,The Intruder,36599361,35419122,0.9677524697767265,1180239,0.03224753022327357,2019
2727,The Priests,36577134,185093,0.005060347265042691,36392041,0.9949396527349573,2015
2728,The Tower,36512327,0,0.0,36512327,1.0,2012
2729,The Chaser,36467587,0,0.0,36467587,1.0,2008
2730,Brooklyn's Finest,36440201,27163593,0.7454292856397801,9276608,0.2545707143602199,2009
2731,Detective Conan: The Lost Ship in the Sky,36407407,0,0.0,36407407,1.0,2010
2732,The Boat That Rocked,36348784,8017917,0.22058281234387372,28330867,0.7794171876561262,2009
2733,Detective Conan: Private Eye in the Distant Sea,36324232,0,0.0,36324232,1.0,2013
2734,Secret Reunion,36298578,0,0.0,36298578,1.0,2010
2735,Furry Vengeance,36288132,17630465,0.48584658477322556,18657667,0.5141534152267744,2010
2736,A Most Wanted Man,36233517,17237855,0.4757433566275115,18995662,0.5242566433724886,2014
2737,A Very Harold & Kumar Christmas,36192775,35061031,0.9687301125708101,1131744,0.031269887429189944,2011
2738,Nobunaga Concerto: The Movie,36187594,0,0.0,36187594,1.0,2016
2739,Dügün Dernek,36185741,0,0.0,36185741,1.0,2013
2740,The Confidence Man JP: Princess,36109913,0,0.0,36109913,1.0,2020
2741,Sicko,36093504,24540079,0.6799029265764831,11553425,0.3200970734235169,2007
2742,Love Happens,36088028,22965110,0.6363636716309353,13122918,0.3636363283690647,2009
2743,Nothing to Lose,36075317,1016188,0.028168512005036575,35059129,0.9718314879949634,2018
2744,The Magic Hour,36023586,0,0.0,36023586,1.0,2008
2745,Whatever Works,36020534,5306706,0.14732446776052793,30713828,0.8526755322394721,2009
2746,T-34,35950901,0,0.0,35950901,1.0,2018
2747,Kundo: Age of the Rampant,35941291,280958,0.00781713711953196,35660333,0.9921828628804681,2014
2748,Ra.One,35911689,2511689,0.06994070927713815,33400000,0.9300592907228619,2011
2749,You Will Meet a Tall Dark Stranger,35867322,3248246,0.09056282484652743,32619076,0.9094371751534726,2010
2750,Doraemon the Movie: The New Records of Nobita's Spaceblazer 2014 Re-release,35861856,0,0.0,35861856,1.0,2014
2751,Garden State,35825316,26782316,0.747580733132961,9043000,0.2524192668670389,2004
2752,Conquest 1453,35797045,35730,0.0009981270800425008,35761315,0.9990018729199575,2012
2753,The New Adventures of Aladdin,35771820,0,0.0,35771820,1.0,2015
2754,Heidi,35755670,0,0.0,35755670,1.0,2015
2755,Riding in Cars with Boys,35743308,30165536,0.8439491946296632,5577772,0.15605080537033675,2001
2756,Hostel: Part II,35728183,17609452,0.4928728673383698,18118731,0.5071271326616302,2007
2757,"Tad, the Lost Explorer, and the Secret of King Midas",35704046,5874,0.00016451916962016014,35698172,0.9998354808303799,2017
2758,The Addams Family 2,35701891,31140891,0.8722476632960422,4561000,0.12775233670395778,2021
2759,Hostiles,35669017,29819114,0.835994835517895,5849903,0.164005164482105,2017
2760,The Terror Live,35659824,0,0.0,35659824,1.0,2013
2761,Faster,35626958,23240020,0.6523155864163311,12386938,0.34768441358366886,2010
2762,Good Deeds,35579177,35025791,0.9844463518647438,553386,0.015553648135256191,2012
2763,My Dog Skip,35547761,34134641,0.9602472853353549,1413120,0.039752714664645125,2000
2764,The Queen's Corgi,35515687,0,0.0,35515687,1.0,2019
2765,Jersey Girl,35492921,25268157,0.7119210334928477,10224764,0.28807896650715226,2004
2766,Mia and the White Lion,35487190,399471,0.011256766173934877,35087719,0.9887432338260651,2018
2767,Arbitrage,35485056,7919574,0.22318054112694652,27565482,0.7768194588730535,2012
2768,Hide and Seek,35461505,0,0.0,35461505,1.0,2013
2769,Vacancy,35442935,19363565,0.5463307426430684,16079370,0.45366925735693164,2007
2770,Original Sin,35402320,16534221,0.46703778170470184,18868099,0.5329622182952981,2001
2771,Room,35401758,14677654,0.4146024047732319,20724104,0.5853975952267682,2015
2772,Namiya,35351623,70814,0.0020031329254670996,35280809,0.997996867074533,2017
2773,Death Note: L Change the World,35319632,0,0.0,35319632,1.0,2008
2774,The Darjeeling Limited,35307949,11902715,0.337111481609991,23405234,0.662888518390009,2007
2775,Assault on Precinct 13,35294470,20040895,0.5678196896000989,15253575,0.4321803103999012,2005
2776,Eye in the Sky,35259653,18704595,0.5304815393390286,16555058,0.46951846066097136,2016
2777,Les Tuche 2: The American Dream,35210425,0,0.0,35210425,1.0,2016
2778,Courageous,35185884,34522221,0.9811383735591239,663663,0.01886162644087612,2011
2779,Destiny: The Tale of Kamakura,35166640,0,0.0,35166640,1.0,2017
2780,The Girl in the Spider's Web,35164920,14841338,0.42204953118050603,20323582,0.577950468819494,2018
2781,The Adventures of Rocky & Bullwinkle,35134820,26005820,0.7401722849298786,9129000,0.2598277150701213,2000
2782,The Secret in Their Eyes,35079650,6391436,0.18219782694525175,28688214,0.8178021730547482,2009
2783,Miss Potter,35078241,3005605,0.08568288814709951,32072636,0.9143171118529005,2006
2784,Alfie,35060882,13399812,0.3821869626668262,21661070,0.6178130373331737,2004
2785,My Week with Marilyn,35057696,14600347,0.4164662446727817,20457349,0.5835337553272183,2011
2786,The Liquidator,35046130,0,0.0,35046130,1.0,2017
2787,Flight of the Phoenix,35021497,21009180,0.5998938309233326,14012317,0.4001061690766674,2004
2788,Welcome to the North,34995189,0,0.0,34995189,1.0,2012
2789,I Fell in Love Like a Flower Bouquet,34975905,0,0.0,34975905,1.0,2021
2790,Bambi and the Great Prince of the Forest,34958637,0,0.0,34958637,1.0,2006
2791,Blind Detective,34958596,0,0.0,34958596,1.0,2013
2792,When Marnie Was There,34949567,561085,0.016054133088401354,34388482,0.9839458669115987,2014
2793,The Sitter,34942188,30441326,0.8711911801287315,4500862,0.12880881987126852,2011
2794,The Hate U Give,34934009,29719483,0.8507321046376326,5214526,0.14926789536236737,2018
2795,Lost and Love,34930177,188817,0.005405555202311171,34741360,0.9945944447976889,2015
2796,Gomorrah,34861529,1579146,0.045297668957663906,33282383,0.9547023310423361,2008
2797,Secret in Their Eyes,34854990,20180155,0.578974631752871,14674835,0.42102536824712905,2015
2798,"Dad, Where Are We Going 2",34840000,0,0.0,34840000,1.0,2015
2799,Chimpanzee,34823764,28972764,0.8319825507661952,5851000,0.16801744923380482,2012
2800,Disaster Movie,34816824,14190901,0.40758746403750096,20625923,0.5924125359624991,2008
2801,Kidnap,34814102,30971040,0.8896119164584513,3843062,0.11038808354154876,2017
2802,Doraemon: Nobita and the Space Heroes,34811747,0,0.0,34811747,1.0,2015
2803,The Life Aquatic with Steve Zissou,34808403,24020403,0.6900748362399735,10788000,0.30992516376002655,2004
2804,Sunshine,34806360,3675753,0.10560578583913974,31130607,0.8943942141608603,2007
2805,Assembly,34786960,0,0.0,34786960,1.0,2007
2806,Broken City,34737199,19701164,0.5671488941868917,15036035,0.4328511058131083,2013
2807,Endless Love,34718173,23438250,0.6751003285800782,11279923,0.32489967141992177,2014
2808,Jane Eyre,34710627,11242660,0.3238967708650149,23467967,0.6761032291349851,2011
2809,The Kids Are All Right,34705850,20811365,0.5996500589958177,13894485,0.4003499410041823,2010
2810,Doraemon The Movie: Nobita's Great Battle of the Mermaid King,34702573,0,0.0,34702573,1.0,2010
2811,Nana,34671042,0,0.0,34671042,1.0,2005
2812,The Man Standing Next,34664900,113527,0.003274984205925879,34551373,0.9967250157940741,2020
2813,Malibu's Most Wanted,34622504,34432201,0.9945034882514563,190303,0.005496511748543664,2003
2814,Alex Cross,34618867,25888412,0.7478122262060165,8730455,0.2521877737939835,2012
2815,Gone Baby Gone,34612443,20292962,0.5862909474491587,14319481,0.41370905255084134,2007
2816,The Extraordinary Adventures of Adèle Blanc-Sec,34604339,0,0.0,34604339,1.0,2010
2817,R.A.I.D. Special Unit,34598750,0,0.0,34598750,1.0,2017
2818,Crank: High Voltage,34572541,13684249,0.3958126479624393,20888292,0.6041873520375607,2009
2819,Salmon Fishing in the Yemen,34564651,9047981,0.2617697774526929,25516670,0.7382302225473071,2012
2820,Haywire,34513760,18942396,0.548836058430029,15571364,0.4511639415699709,2012
2821,Steve Jobs,34441873,17766658,0.515844710303647,16675215,0.484155289696353,2015
2822,Adventures in Zambezia,34428345,0,0.0,34428345,1.0,2012
2823,Swimfan,34411240,28564995,0.8301065291457094,5846245,0.16989347085429063,2002
2824,My Mom is a Character 3,34360029,0,0.0,34360029,1.0,2020
2825,Pokémon the Movie: Destiny Deoxys,34337258,0,0.0,34337258,1.0,2004
2826,Warrior of the Hornor,34291831,0,0.0,34291831,1.0,2019
2827,The Medallion,34268701,22219192,0.648381507078427,12049509,0.35161849292157293,2003
2828,American Psycho,34266564,15070285,0.43979562701413544,19196279,0.5602043729858646,2000
2829,Wild Safari - A South African Adventure,34257135,16621530,0.48519906874874386,17635605,0.5148009312512561,2005
2830,Bad News Bears,34252847,32868349,0.95958006060051,1384498,0.040419939399489915,2005
2831,Victor Frankenstein,34227298,5775076,0.16872719546836562,28452222,0.8312728045316343,2015
2832,The House,34184504,25584504,0.748424022767743,8600000,0.25157597723225705,2017
2833,Cirque du Soleil: Worlds Away,34153101,12512862,0.36637557450493297,21640239,0.633624425495067,2012
2834,The Battle: Roar to Victory,34148707,0,0.0,34148707,1.0,2019
2835,Black & White: The Dawn of Justice,34146896,0,0.0,34146896,1.0,2014
2836,Gokusen: The Movie,34117482,0,0.0,34117482,1.0,2009
2837,In Bruges,34085749,7800824,0.22885881134664227,26284925,0.7711411886533578,2008
2838,The Bad Guys: The Movie,34024386,166972,0.004907421400638942,33857414,0.9950925785993611,2019
2839,"My Love, Don't Cross That River",34012261,0,0.0,34012261,1.0,2014
2840,Darkness,33988736,22163442,0.6520819720980504,11825294,0.34791802790194964,2002
2841,Dungeons & Dragons,33978694,15391970,0.45298886413939277,18586724,0.5470111358606072,2000
2842,The Fighting Temptations,33972062,30250745,0.8904594899185101,3721317,0.1095405100814899,2003
2843,The Witness,33963557,418063,0.012309164202088727,33545494,0.9876908357979113,2015
2844,Doraemon the Movie: Nobita's New Dinosaur,33942341,0,0.0,33942341,1.0,2020
2845,Hotel Rwanda,33882243,23530892,0.6944903854210597,10351351,0.3055096145789404,2004
2846,Camping 2,33857735,0,0.0,33857735,1.0,2010
2847,The Good Liar,33856058,17156058,0.5067352495674482,16700000,0.49326475043255186,2019
2848,Don't Go Breaking My Heart 2,33801759,0,0.0,33801759,1.0,2014
2849,Jay and Silent Bob Strike Back,33788161,30085147,0.890404985343831,3703014,0.10959501465616907,2001
2850,The Art of Racing in the Rain,33766787,26395642,0.7817042823766442,7371145,0.21829571762335576,2019
2851,Love and Honor,33755574,60910,0.0018044427269996949,33694664,0.9981955572730004,2006
2852,I Want to Eat Your Pancreas,33748006,277019,0.008208455338072419,33470987,0.9917915446619275,2017
2853,Deliver Us from Evil,33718703,0,0.0,33718703,1.0,2020
2854,Nobody's Fool,33705333,31713110,0.9408929441521909,1992223,0.05910705584780901,2018
2855,Mr. Woodcock,33683200,25799486,0.7659452189815694,7883714,0.23405478101843055,2007
2856,The Skin I Live In,33678406,3185812,0.09459509455405936,30492594,0.9054049054459407,2011
2857,Three Heroes on Distant Shores,33674759,0,0.0,33674759,1.0,2012
2858,Gantz: Perfect Answer,33672515,0,0.0,33672515,1.0,2011
2859,Y tu mamá también,33616692,13839658,0.411690061592021,19777034,0.588309938407979,2001
2860,Because of Winn-Dixie,33589427,32647042,0.9719439989256143,942385,0.0280560010743857,2005
2861,Punch,33556725,0,0.0,33556725,1.0,2011
2862,Nick and Norah's Infinite Playlist,33556631,31487293,0.938332963163078,2069338,0.06166703683692204,2008
2863,Bloodshot,33542457,12561824,0.37450518308781017,20980633,0.6254948169121898,2020
2864,Friday After Next,33526835,33253609,0.9918505280919001,273226,0.008149471908099885,2002
2865,Arthur 3: The War of the Two Worlds,33519334,0,0.0,33519334,1.0,2010
2866,Run Fatboy Run,33478921,6003262,0.17931467982495614,27475659,0.8206853201750439,2007
2867,Fireproof,33473297,33456317,0.9994927299811548,16980,0.0005072700188451709,2008
2868,Red Planet,33463969,17480890,0.5223794583362182,15983079,0.4776205416637817,2000
2869,2016: Obama's America,33449086,33449086,1.0,0,0.0,2012
2870,Get on Up,33448971,30703100,0.9179086555457865,2745871,0.08209134445421355,2014
2871,Wonder Boys,33426588,19393557,0.5801835652505125,14033031,0.41981643474948743,2000
2872,Tell No One,33406992,6177192,0.1849071595551015,27229800,0.8150928404448985,2006
2873,Pokémon: Jirachi - Wish Maker,33393751,0,0.0,33393751,1.0,2003
2874,The Perks of Being a Wallflower,33384127,17742948,0.5314785676438386,15641179,0.46852143235616134,2012
2875,The Box,33333531,15051977,0.45155663226917064,18281554,0.5484433677308294,2009
2876,Girls,33325338,0,0.0,33325338,1.0,2014
2877,The Cave,33296457,15007991,0.450738377359489,18288466,0.5492616226405109,2005
2878,Marathon,33284089,0,0.0,33284089,1.0,2005
2879,Che: Part One,33266274,0,0.0,33266274,1.0,2008
2880,Perfect Strangers,33262366,1014507,0.03050014541960124,32247859,0.9694998545803988,2017
2881,Confessions of a Teenage Drama Queen,33251890,29331068,0.8820872437626853,3920822,0.11791275623731463,2004
2882,Project Almanac,33213241,22348241,0.6728714310054836,10865000,0.32712856899451637,2015
2883,Bharat,33185983,2971549,0.08954229259986062,30214434,0.9104577074001394,2019
2884,Baaghi 2,33139063,1319579,0.039819442088631175,31819484,0.9601805579113688,2018
2885,The Crocodile Hunter: Collision Course,33082548,28442574,0.8597455673607728,4639974,0.14025443263922718,2002
2886,Girl with a Pearl Earring,33030115,11670971,0.3533433353168767,21359144,0.6466566646831232,2003
2887,The Brice Man,33026616,0,0.0,33026616,1.0,2005
2888,Dogwood Tree,33016351,0,0.0,33016351,1.0,2010
2889,Confessions of a Dangerous Mind,33013805,16007718,0.4848795223695057,17006087,0.5151204776304943,2002
2890,Lockout,32948113,14326864,0.43483109336185655,18621249,0.5651689066381435,2012
2891,Inside Llewyn Davis,32935319,13235319,0.40185792644060925,19700000,0.5981420735593908,2013
2892,Sleepless,32917353,20783704,0.6313905009312262,12133649,0.3686094990687738,2017
2893,Brightburn,32893421,17300439,0.5259543846169117,15592982,0.4740456153830883,2019
2894,7 Dwarves: The Forest Is Not Enough,32863752,0,0.0,32863752,1.0,2006
2895,Les profs,32849727,0,0.0,32849727,1.0,2013
2896,Hindi Medium,32841493,0,0.0,32841493,1.0,2017
2897,Bait,32813407,0,0.0,32813407,1.0,2012
2898,The Crossing,32806475,0,0.0,32806475,1.0,2014
2899,Fly Me to the Saitama,32802347,0,0.0,32802347,1.0,2019
2900,Adaptation.,32801173,22498520,0.6859059583021619,10302653,0.31409404169783806,2002
2901,Big Red Envelope,32800000,0,0.0,32800000,1.0,2021
2902,Old Boys: The Way of the Dragon,32800000,0,0.0,32800000,1.0,2014
2903,Doraemon the Movie: Nobita's New Great Adventure into the Underworld,32787846,0,0.0,32787846,1.0,2007
2904,Steel Rain,32783733,0,0.0,32783733,1.0,2017
2905,LOL (Laughing Out Loud) ®,32764784,0,0.0,32764784,1.0,2009
2906,Awake,32730062,14377198,0.439265834571288,18352864,0.560734165428712,2007
2907,Part of Me,32726956,25326071,0.7738596586862524,7400885,0.2261403413137476,2012
2908,Leap Year,32686500,25918920,0.7929548896333348,6767580,0.20704511036666515,2010
2909,Mud,32613173,21590086,0.6620050738393348,11023087,0.3379949261606652,2013
2910,88 Minutes,32593385,17213467,0.5281276246698525,15379918,0.47187237533014753,2007
2911,Cry Wolf,32586408,10047674,0.30833941562383926,22538734,0.6916605843761607,2005
2912,Last Chance Harvey,32566966,14889042,0.4571823485184343,17677924,0.5428176514815657,2008
2913,The Musketeer,32533802,27073640,0.832169569360507,5460162,0.16783043063949304,2001
2914,The Hurricane Heist,32517248,6115825,0.18807941557661953,26401423,0.8119205844233804,2018
2915,Midsummer's Equation,32514549,0,0.0,32514549,1.0,2013
2916,REC,32511655,0,0.0,32511655,1.0,2007
2917,Fighting,32482728,23091010,0.7108704047270906,9391718,0.2891295952729093,2009
2918,Nameless Gangster: Rules of the Time,32472645,0,0.0,32472645,1.0,2012
2919,UglyDolls,32450241,20150241,0.6209581309426947,12300000,0.3790418690573053,2019
2920,Movie 43,32438988,8840453,0.2725255485775327,23598535,0.7274744514224674,2012
2921,The House That Never Dies II,32433588,0,0.0,32433588,1.0,2017
2922,The Invention of Lying,32406507,18451251,0.5693687073401648,13955256,0.43063129265983524,2009
2923,Night Watch,32396890,0,0.0,32396890,1.0,2004
2924,Dhoom 2,32396427,2643586,0.08160115928833757,29752841,0.9183988407116624,2006
2925,Stuber,32390945,22370452,0.6906390659488323,10020493,0.3093609340511677,2019
2926,Detective K: Secret of Virtuous Widow,32358664,0,0.0,32358664,1.0,2011
2927,Alpha Dog,32351125,15309602,0.47323244554864785,17041523,0.5267675544513521,2007
2928,The Wave,32350637,0,0.0,32350637,1.0,2008
2929,Hit Me Anyone One More Time!,32333512,0,0.0,32333512,1.0,2019
2930,Kevin Hart: Let Me Explain,32318051,32244051,0.997710257960791,74000,0.002289742039208986,2013
2931,Potiche,32309881,1618844,0.050103681904616115,30691037,0.9498963180953839,2010
2932,Pokémon,32293377,0,0.0,32293377,1.0,2013
2933,Hart's War,32287044,19077641,0.5908760492289106,13209403,0.4091239507710895,2002
2934,Seven Psychopaths,32226382,15024049,0.4662034044032619,17202333,0.5337965955967381,2012
2935,Somewhere Winter,32218990,0,0.0,32218990,1.0,2019
2936,Once Upon a Time in Hong Kong,32218874,0,0.0,32218874,1.0,2021
2937,Home Sweet Home,32178677,0,0.0,32178677,1.0,2021
2938,Reindeer Games,32168970,23368995,0.7264452358903627,8799975,0.2735547641096373,2000
2939,The After-Dinner Mysteries,32160741,0,0.0,32160741,1.0,2013
2940,The Kid Who Would Be King,32140970,16790790,0.5224108046521309,15350180,0.4775891953478691,2019
2941,Amazing Grace,32120360,21250683,0.6615954179841073,10869677,0.33840458201589274,2007
2942,April Bride,32112343,0,0.0,32112343,1.0,2009
2943,The Suspect: Muroi Shinji,32104229,0,0.0,32104229,1.0,2005
2944,You Again,32054369,25702053,0.8018268274131367,6352316,0.1981731725868633,2010
2945,Malignant,32003983,13203983,0.41257311628993176,18800000,0.5874268837100682,2021
2946,Two Tigers,32001580,0,0.0,32001580,1.0,2019
2947,Os Dez Mandamentos - O Filme,31998251,0,0.0,31998251,1.0,2016
2948,Dilwale,31994323,4871263,0.15225397955756087,27123060,0.8477460204424391,2015
2949,Stick It,31976848,26910736,0.8415693754431331,5066112,0.1584306245568669,2006
2950,Suffragette,31972096,4702420,0.1470788777814254,27269676,0.8529211222185746,2015
2951,The Floating Castle,31967471,0,0.0,31967471,1.0,2012
2952,The Neighbors,31949315,0,0.0,31949315,1.0,2012
2953,Hunting and Gathering,31920899,0,0.0,31920899,1.0,2007
2954,All About Me,31920159,0,0.0,31920159,1.0,2018
2955,Bounty Hunters,31918573,0,0.0,31918573,1.0,2016
2956,Bad Times at the El Royale,31882724,17839115,0.5595229253309724,14043609,0.44047707466902764,2018
2957,The Seeker: The Dark Is Rising,31852619,8794452,0.2760982385781213,23058167,0.7239017614218787,2007
2958,Tinker Bell and the Legend of the NeverBeast,31836701,0,0.0,31836701,1.0,2014
2959,Marrying the Mafia 2: Enemy-in-Law,31835989,0,0.0,31835989,1.0,2005
2960,The Dream Team,31822402,0,0.0,31822402,1.0,2012
2961,Self/less,31807156,12279691,0.38606692783221486,19527465,0.6139330721677851,2015
2962,Blood Work,31794718,26235081,0.825139603376888,5559637,0.17486039662311206,2002
2963,Welcome to Dongmakgol,31787130,0,0.0,31787130,1.0,2005
2964,Underdogs,31775719,0,0.0,31775719,1.0,2013
2965,Spring Breakers,31724284,14124284,0.44521994570468476,17600000,0.5547800542953152,2013
2966,Doraemon the Movie: Nobita and the Green Giant Legend,31684949,0,0.0,31684949,1.0,2008
2967,Suddenly Paradise,31679869,0,0.0,31679869,1.0,2003
2968,Hunter Killer,31672678,15767460,0.49782528651350544,15905218,0.5021747134864946,2018
2969,Rent,31670620,29077547,0.918123705819463,2593073,0.08187629418053705,2005
2970,New World,31670607,457806,0.014455232891494628,31212801,0.9855447671085054,2013
2971,Ae Dil Hai Mushkil,31668920,4264983,0.1346740905594507,27403937,0.8653259094405493,2016
2972,Anna,31626978,7743794,0.2448477372703772,23883184,0.7551522627296228,2019
2973,Super Troopers 2,31626386,30617396,0.9680965760678442,1008990,0.03190342393215589,2018
2974,Daddy's Little Girls,31609243,31366978,0.9923356279047872,242265,0.007664372095212783,2007
2975,Double Take,31603059,29831583,0.9439460591457302,1771476,0.05605394085426983,2001
2976,Love in the Time of Cholera,31575877,4607608,0.14592177439758838,26968269,0.8540782256024116,2007
2977,Jennifer's Body,31556061,16204793,0.5135239471111429,15351268,0.4864760528888571,2009
2978,The Four 3,31521335,0,0.0,31521335,1.0,2014
2979,Bodyguard,31516209,1834384,0.058204462345074565,29681825,0.9417955376549254,2011
2980,The New World 2005 Re-release,31510855,12712093,0.4034194883001429,18798762,0.596580511699857,2005
2981,The Thing,31505287,16928670,0.5373279094394537,14576617,0.46267209056054626,2011
2982,Harry Potter and the Sorcerer's Stone 2020 Re-release,31501815,0,0.0,31501815,1.0,2020
2983,Dance Flick,31439140,25662155,0.8162486314829223,5776985,0.18375136851707777,2009
2984,A Serious Man,31430334,9228768,0.2936261510933991,22201566,0.7063738489066008,2009
2985,I Don't Know How She Does It,31410151,9662284,0.3076166045811114,21747867,0.6923833954188886,2011
2986,Lost Souls,31355910,16815253,0.5362706105483783,14540657,0.46372938945162173,2000
2987,Honest Thief,31354158,14163574,0.4517287308432904,17190584,0.5482712691567097,2020
2988,Assassination Classroom: The Graduation,31352921,0,0.0,31352921,1.0,2016
2989,"All's Well, Ends Well 2011",31335572,0,0.0,31335572,1.0,2011
2990,Johnson Family Vacation,31326183,31203964,0.9960985032871703,122219,0.003901496712829648,2004
2991,Respect,31324457,24223457,0.7733081215102947,7101000,0.22669187848970535,2021
2992,What's in a Name?,31303580,8111,0.00025910774422605975,31295469,0.9997408922557739,2012
2993,101 Proposals,31283838,0,0.0,31283838,1.0,2013
2994,How High,31283740,31178740,0.9966436238122424,105000,0.003356376187757602,2001
2995,Tazza: The Hidden Card,31278476,251555,0.008042431479078457,31026921,0.9919575685209215,2014
2996,Deutschland. Ein Sommermärchen,31257991,0,0.0,31257991,1.0,2006
2997,Perfect Strangers,31254929,0,0.0,31254929,1.0,2016
2998,Saving Mr. Wu,31222161,92696,0.0029689168536412326,31129465,0.9970310831463588,2015
2999,Welcome,31203567,0,0.0,31203567,1.0,2007
3000,Pride and Glory,31200557,15740721,0.5045012818200649,15459836,0.49549871817993507,2008
3001,The Stepfather,31198531,29062561,0.9315361995729863,2135970,0.0684638004270137,2009
3002,The Invisible Guest,31191910,0,0.0,31191910,1.0,2017
3003,My Dear Liar,31177968,90545,0.0029041340987969455,31087423,0.997095865901203,2019
3004,The Blind Swordsman: Zatoichi,31167430,0,0.0,31167430,1.0,2003
3005,The New Guy,31167388,29760152,0.9548490877708457,1407236,0.0451509122291544,2002
3006,Joyful Noise,31158113,30932113,0.9927466724316714,226000,0.007253327568328673,2012
3007,Mrs. Brown's Boys D'Movie,31116264,0,0.0,31116264,1.0,2014
3008,Train Man,31090100,0,0.0,31090100,1.0,2005
3009,Premium Rush,31083599,20275446,0.6522875938529512,10808153,0.3477124061470488,2012
3010,Ultraviolet,31070211,18535812,0.5965782466041186,12534399,0.4034217533958813,2006
3011,The Wild Goose Lake,31065122,12573,0.0004047304240427577,31052549,0.9995952695759572,2019
3012,The Strangers: Prey at Night,31039126,24586708,0.7921198554366512,6452418,0.20788014456334886,2018
3013,Beauty and the Beast 2000 IMAX Release,31033346,25487190,0.8212839827197492,5546156,0.17871601728025074,2001
3014,Vysotsky. Thank You for Being Alive,31016553,0,0.0,31016553,1.0,2011
3015,This Is Not What I Expected,30996615,337670,0.010893770174581966,30658945,0.9891062298254181,2017
3016,Silenced,30996130,0,0.0,30996130,1.0,2011
3017,Joe Dirt,30987695,27087695,0.8741435915126956,3900000,0.1258564084873044,2001
3018,Pathfinder,30984583,10232081,0.3302313605446941,20752502,0.6697686394553058,2007
3019,Doraemon the Movie: Nobita's Dinosaur,30963292,0,0.0,30963292,1.0,2006
3020,Playing for Keeps,30962335,13103272,0.42320038201253235,17859063,0.5767996179874677,2012
3021,Rise of the Legend,30932534,0,0.0,30932534,1.0,2014
3022,Billy Lynn's Long Halftime Walk,30930984,1738477,0.05620503376161586,29192507,0.9437949662383841,2016
3023,The Promise,30925693,669625,0.021652707992671338,30256068,0.9783472920073286,2005
3024,Hearts in Atlantis,30919415,24185781,0.7822198770578292,6733634,0.2177801229421708,2001
3025,Pandora,30896701,0,0.0,30896701,1.0,2016
3026,Gintama 2: Rules are Made to be Broken,30896653,0,0.0,30896653,1.0,2018
3027,Igor,30893885,19528602,0.632118686270762,11365283,0.367881313729238,2008
3028,African Cats,30857747,15428747,0.499995900543225,15429000,0.500004099456775,2011
3029,The Unholy,30830440,15530440,0.5037372155570923,15300000,0.4962627844429077,2021
3030,Attack on Titan Part 1,30810658,449523,0.014589853939503662,30361135,0.9854101460604964,2015
3031,Winter's Tale,30800231,12600231,0.40909534087585253,18200000,0.5909046591241475,2014
3032,Monsoon Wedding,30787356,13885966,0.45102820781362324,16901390,0.5489717921863768,2001
3033,Wolf Creek,30762648,16188180,0.5262284313105946,14574468,0.4737715686894054,2005
3034,Norm of the North,30734502,17062499,0.5551578157993254,13672003,0.44484218420067456,2016
3035,Carnage,30722632,2547047,0.08290458317503527,28175585,0.9170954168249648,2011
3036,A Man Called Ove,30692889,3479315,0.11335899334858963,27213574,0.8866410066514103,2015
3037,Nancy Drew,30666930,25612520,0.8351836978791161,5054410,0.16481630212088397,2007
3038,A Wedding Invitation,30665036,14350,0.0004679596658552757,30650686,0.9995320403341448,2013
3039,Death Proof,30663961,0,0.0,30663961,1.0,2007
3040,When the Bough Breaks,30658387,29747603,0.9702925010373181,910784,0.02970749896268189,2016
3041,Wild Tales,30642704,3106530,0.10137910805782675,27536174,0.8986208919421732,2014
3042,City of God,30641770,7564459,0.2468675601964247,23077311,0.7531324398035754,2002
3043,Twosabu ilchae,30622421,0,0.0,30622421,1.0,2006
3044,The Last Warrior,30618274,0,0.0,30618274,1.0,2017
3045,Be Kind Rewind,30579406,11175164,0.36544738638808094,19404242,0.6345526136119191,2008
3046,Cabin Fever,30553394,21158188,0.6924987777135332,9395206,0.30750122228646676,2003
3047,Two for the Money,30526509,22991379,0.7531610968027821,7535130,0.24683890319721788,2005
3048,The Best Movie,30525503,0,0.0,30525503,1.0,2008
3049,A Dangerous Method,30519436,5704709,0.18692052500577008,24814727,0.81307947499423,2011
3050,The Four,30505808,0,0.0,30505808,1.0,2012
3051,Mesrine: Killer Instinct,30503743,0,0.0,30503743,1.0,2008
3052,Natale a New York,30437121,0,0.0,30437121,1.0,2006
3053,What's Your Number?,30426096,14011084,0.4604956219161341,16415012,0.5395043780838659,2011
3054,Like a Boss,30399490,22169514,0.7292725634541896,8229976,0.2707274365458105,2020
3055,A Beautiful Wife,30385222,0,0.0,30385222,1.0,2007
3056,The Girl Next Door,30381722,14589444,0.4802046440948936,15792278,0.5197953559051064,2004
3057,S Storm,30381402,0,0.0,30381402,1.0,2016
3058,Yatterman,30365792,0,0.0,30365792,1.0,2009
3059,The Way of the Bug,30355804,0,0.0,30355804,1.0,2018
3060,Nocturnal Animals,30311857,10663357,0.3517883117487655,19648500,0.6482116882512345,2016
3061,Doraemon: Nobita and the New Steel Troops: ~Winged Angels~,30236973,0,0.0,30236973,1.0,2011
3062,The Great Debaters,30236407,30236407,1.0,0,0.0,2007
3063,Far from the Madding Crowd,30229977,12236500,0.40478032781831097,17993477,0.595219672181689,2015
3064,Eternal Moment,30186159,0,0.0,30186159,1.0,2011
3065,A Tale of Mari and Three Puppies,30183621,0,0.0,30183621,1.0,2007
3066,The Grand Heist,30158762,0,0.0,30158762,1.0,2012
3067,A Silent Voice: The Movie,30156463,310407,0.010293216415996797,29846056,0.9897067835840032,2016
3068,When the Game Stands Tall,30138754,30127963,0.9996419560012335,10791,0.0003580439987665051,2014
3069,The Rum Diary,30134958,13109815,0.4350367768888213,17025143,0.5649632231111787,2011
3070,Godsend,30120671,14379751,0.47740473643498843,15740920,0.5225952635650115,2004
3071,Clergy,30114115,0,0.0,30114115,1.0,2018
3072,My Own Swordsman,30082188,0,0.0,30082188,1.0,2011
3073,Shaun of the Dead,30076102,13542874,0.45028687560642,16533228,0.54971312439358,2004
3074,I Do: How to Get Married and Stay Single,30057369,0,0.0,30057369,1.0,2006
3075,Laws of Attraction,30031874,17871255,0.5950762513188488,12160619,0.4049237486811512,2003
3076,Solaris,30002758,14973382,0.49906685245403104,15029376,0.500933147545969,2002
3077,Natale a Beverly Hills,29976481,0,0.0,29976481,1.0,2009
3078,My Hero Academia: Heroes Rising,29971229,13304000,0.4438923742499849,16667229,0.5561076257500152,2019
3079,Reset 2017 Re-release,29949252,108970,0.0036384881999724067,29840282,0.9963615118000276,2017
3080,Small Time Crooks,29934477,17266359,0.5768051000189514,12668118,0.4231948999810486,2000
3081,Keeping Up with the Joneses,29918745,14904426,0.4981634757741342,15014319,0.5018365242258658,2016
3082,Rab Ne Bana Di Jodi,29914469,2078956,0.0694966706579348,27835513,0.9305033293420653,2008
3083,Pulse,29907685,20264436,0.6775661840760995,9643249,0.32243381592390047,2006
3084,Crows Zero II,29893636,0,0.0,29893636,1.0,2009
3085,The Four Feathers,29882645,18306166,0.6126019299831056,11576479,0.3873980700168944,2002
3086,The Bye Bye Man,29874280,22395806,0.7496684773658143,7478474,0.2503315226341857,2017
3087,The Little Things,29844012,15244012,0.5107896351201038,14600000,0.48921036487989616,2021
3088,You Are the Apple of My Eye,29843025,0,0.0,29843025,1.0,2011
3089,Draft Day,29824199,28842237,0.9670749916871195,981962,0.03292500831288042,2014
3090,The Disaster Artist,29820616,21120616,0.7082555236283516,8700000,0.2917444763716484,2017
3091,Ice,29806210,0,0.0,29806210,1.0,2018
3092,Jackie,29777777,13960394,0.46881921373781527,15817383,0.5311807862621847,2016
3093,Torrente 4,29737384,0,0.0,29737384,1.0,2011
3094,Lissi und der wilde Kaiser,29733764,0,0.0,29733764,1.0,2007
3095,Battlefield Earth,29725663,21471685,0.7223282118215496,8253978,0.2776717881784504,2000
3096,The Swindlers,29721916,241916,0.008139313764294335,29480000,0.9918606862357057,2017
3097,Angel Eyes,29715606,24174218,0.8135192666102787,5541388,0.1864807333897212,2001
3098,The Raven,29699345,16008272,0.5390109445174632,13691073,0.4609890554825367,2012
3099,Masterminds,29674699,17368022,0.5852804774868988,12306677,0.4147195225131011,2016
3100,Amour,29652180,6739492,0.22728487416439533,22912688,0.7727151258356046,2012
3101,The Sorcerer and the White Snake,29649716,0,0.0,29649716,1.0,2011
3102,Death Note,29630359,0,0.0,29630359,1.0,2006
3103,Cursed,29621722,19297522,0.6514652321698245,10324200,0.34853476783017545,2005
3104,An American Haunting,29612137,16298046,0.5503839861337937,13314091,0.44961601386620625,2006
3105,The Fox & the Child,29610210,0,0.0,29610210,1.0,2007
3106,W.,29560587,25534493,0.8638019603602595,4026094,0.1361980396397406,2008
3107,In the Valley of Elah,29541790,6777741,0.22942892086092279,22764049,0.7705710791390772,2007
3108,Escape from Mogadishu,29536538,337512,0.011426931619406446,29199026,0.9885730683805936,2021
3109,20th Century Boys 2: The Last Hope,29502213,0,0.0,29502213,1.0,2009
3110,Rajneeti,29459596,1514558,0.051411363550267285,27945038,0.9485886364497327,2010
3111,The Pledge,29419291,19733089,0.670753384233495,9686202,0.32924661576650505,2001
3112,The Valet,29414553,1926800,0.0655049899959384,27487753,0.9344950100040615,2006
3113,City by the Sea,29414087,22449000,0.7632057388012757,6965087,0.23679426119872427,2002
3114,Luther,29413900,5791328,0.19689085772372925,23622572,0.8031091422762707,2003
3115,The Losers,29397654,23591432,0.8024936955853689,5806222,0.19750630441463118,2010
3116,Free Solo,29390279,17541090,0.5968330549022689,11849189,0.4031669450977311,2018
3117,Bugs!,29388999,19063544,0.6486625828936875,10325455,0.35133741710631244,2003
3118,All About My Wife,29382038,0,0.0,29382038,1.0,2012
3119,Baby Boy,29381649,28734552,0.977976151032231,647097,0.022023848967768964,2001
3120,Alibi.com,29370592,0,0.0,29370592,1.0,2017
3121,Across the Universe,29367143,24343673,0.828942502169857,5023470,0.17105749783014304,2007
3122,Nurse Betty,29360400,25170054,0.8572789880246863,4190346,0.1427210119753137,2000
3123,Mr. Holmes,29355203,17737646,0.6042419805443008,11617557,0.3957580194556992,2015
3124,Rowdy Rathore,29342463,777373,0.02649310659435781,28565090,0.9735068934056422,2012
3125,Sword Art Online the Movie: Ordinal Scale,29322339,1522976,0.05193910349375607,27799363,0.9480608965062439,2017
3126,Christmas on the Nile,29320869,0,0.0,29320869,1.0,2002
3127,Silent Witness,29315945,0,0.0,29315945,1.0,2013
3128,The Class,29303505,3766810,0.12854469115554606,25536695,0.8714553088444539,2008
3129,My Hero Academia: World Heroes' Mission,29257746,0,0.0,29257746,1.0,2021
3130,Big Eyes,29253166,14482031,0.495058586137309,14771135,0.504941413862691,2014
3131,Fall In Love At First Kiss,29206238,0,0.0,29206238,1.0,2019
3132,The Young Victoria,29181829,11001272,0.3769904895268902,18180557,0.6230095104731098,2009
3133,The Santa Claus Gang,29181330,0,0.0,29181330,1.0,2010
3134,Dark Figure of Crime,29176133,0,0.0,29176133,1.0,2018
3135,Flight Crew,29171110,0,0.0,29171110,1.0,2016
3136,Singh Is King,29169677,2159376,0.0740281080246449,27010301,0.9259718919753551,2008
3137,Unfair: The Answer,29166054,0,0.0,29166054,1.0,2011
3138,Viking,29161298,0,0.0,29161298,1.0,2016
3139,Yu-Gi-Oh!: The Movie - Pyramid of Light,29144802,19765868,0.6781953090640314,9378934,0.32180469093596864,2004
3140,Dragon,29140858,0,0.0,29140858,1.0,2011
3141,Special ID,29139936,12666,0.0004346612154535961,29127270,0.9995653387845465,2013
3142,Cold Creek Manor,29119434,21386011,0.7344239932685505,7733423,0.26557600673144954,2003
3143,Sacrifice,29093560,29792,0.0010240066873906115,29063768,0.9989759933126093,2010
3144,St. Trinian's,29066483,0,0.0,29066483,1.0,2007
3145,The Fatal Encounter,29060186,0,0.0,29060186,1.0,2014
3146,Pad Man,29045020,1670192,0.057503558269197265,27374828,0.9424964417308027,2018
3147,Far from Heaven,29027914,15901849,0.5478123229936537,13126065,0.4521876770063464,2002
3148,SPEC: Heaven,29023960,0,0.0,29023960,1.0,2012
3149,New in Town,29010817,16734283,0.5768290841309295,12276534,0.4231709158690705,2009
3150,The Unbroken,29000322,0,0.0,29000322,1.0,2009
3151,Shorts,28972508,20919166,0.7220350409429519,8053342,0.27796495905704816,2009
3152,Recep Ivedik 5,28952258,0,0.0,28952258,1.0,2017
3153,Family Honor,28903789,0,0.0,28903789,1.0,2002
3154,M.S. Dhoni: The Untold Story,28903047,1801550,0.06233079854867897,27101497,0.937669201451321,2016
3155,We Were There: True Love,28876929,0,0.0,28876929,1.0,2012
3156,Agent Cody Banks 2: Destination London,28818995,23630159,0.8199508345103638,5188836,0.18004916548963626,2004
3157,Kokowääh 2,28811936,0,0.0,28811936,1.0,2013
3158,Boiler Room,28780255,16970581,0.5896605502626714,11809674,0.4103394497373286,2000
3159,Bol Bachchan,28775262,1216258,0.04226748656536993,27559004,0.9577325134346301,2012
3160,Mirai,28756961,812794,0.028264252262260953,27944167,0.9717357477377391,2018
3161,Pope Joan,28748076,0,0.0,28748076,1.0,2009
3162,Judwaa 2,28733523,1431255,0.04981133013170713,27302268,0.9501886698682929,2017
3163,Yolki 2,28719002,0,0.0,28719002,1.0,2011
3164,Bath Buddy,28700000,0,0.0,28700000,1.0,2020
3165,Master,28692230,0,0.0,28692230,1.0,2021
3166,The Suspect,28674130,218693,0.007626839942484741,28455437,0.9923731600575153,2013
3167,Wrong Turn,28650575,15418790,0.5381668605254868,13231785,0.46183313947451315,2003
3168,The Fortress,28645448,252895,0.008828453302598025,28392553,0.9911715466974019,2017
3169,Love & Mercy,28641776,12551031,0.43820714888629814,16090745,0.5617928511137019,2015
3170,Maya the Bee Movie,28638603,0,0.0,28638603,1.0,2014
3171,The Four 2,28599970,0,0.0,28599970,1.0,2013
3172,Pokémon the Movie: Diancie and the Cocoon of Destruction,28595105,0,0.0,28595105,1.0,2014
3173,Recep Ivedik,28548025,0,0.0,28548025,1.0,2008
3174,Flying Colors,28525563,0,0.0,28525563,1.0,2015
3175,Heist,28510652,23510841,0.8246335790566979,4999811,0.17536642094330218,2001
3176,Ala Vaikunthapurramuloo,28477890,0,0.0,28477890,1.0,2020
3177,Deranged,28444173,0,0.0,28444173,1.0,2012
3178,The Last Warrior: Root of Evil,28357398,0,0.0,28357398,1.0,2021
3179,The Kiyosu Conference,28338665,0,0.0,28338665,1.0,2013
3180,I Give It a Year,28328531,34657,0.0012233955936507969,28293874,0.9987766044063492,2013
3181,Brown Sugar,28316451,27363891,0.9663601911129329,952560,0.0336398088870671,2002
3182,Gully Boy,28288828,5566534,0.19677499541515117,22722294,0.8032250045848488,2019
3183,Thunderbirds,28283637,6880917,0.24328260895159984,21402720,0.7567173910484002,2004
3184,The Master,28258060,16377274,0.5795611588339752,11880786,0.42043884116602487,2012
3185,Fan,28240000,2300000,0.08144475920679886,25940000,0.9185552407932012,2016
3186,The Upside of Anger,28237488,18761993,0.664435625435237,9475495,0.33556437456476296,2005
3187,The Spanish Apartment,28193749,1067438,0.03786080382569909,27126311,0.9621391961743009,2002
3188,Case 39,28190603,13261851,0.4704351659310019,14928752,0.5295648340689981,2009
3189,"Yôkai Watch: the Movie: The Flying Whale and the Grand Adventure of the Double Worlds, Meow!",28110245,0,0.0,28110245,1.0,2016
3190,Triumph in the Skies,28085162,0,0.0,28085162,1.0,2015
3191,Tristan + Isolde,28047963,14734633,0.52533700932221,13313330,0.47466299067779005,2006
3192,Welcome to Germany,28036021,0,0.0,28036021,1.0,2016
3193,Pokemon 4Ever: Celebi - Voice of the Forest,28023563,1727447,0.06164266121335107,26296116,0.938357338786649,2002
3194,Your Highness,28013733,21596445,0.7709234967007075,6417288,0.22907650329929252,2011
3195,The Tailor of Panama,28008462,13729742,0.4901997831940933,14278720,0.5098002168059067,2001
3196,Mandela: Long Walk to Freedom,27985788,8323085,0.29740398948208996,19662703,0.70259601051791,2013
3197,The Brothers Grimsby,27979040,6874837,0.24571382720779555,21104203,0.7542861727922044,2016
3198,What Happened to Monday,27975429,0,0.0,27975429,1.0,2017
3199,The 33,27972023,12227722,0.4371411392018375,15744301,0.5628588607981625,2015
3200,The Little Vampire,27965865,13572400,0.4853202287860576,14393465,0.5146797712139424,2000
3201,The Brothers,27958191,27457409,0.9820881830301539,500782,0.017911816969846152,2001
3202,Priceless,27949650,2165188,0.07746744592508314,25784462,0.9225325540749169,2006
3203,The Divine Move,27926871,136707,0.004895177837860891,27790164,0.9951048221621391,2014
3204,Monster Family,27890108,127259,0.004562872255639885,27762849,0.9954371277443601,2017
3205,Mrs. Henderson Presents,27876417,11036366,0.3959033185649361,16840051,0.6040966814350639,2005
3206,The Beguiled,27869129,10709995,0.3842960072415611,17159134,0.6157039927584389,2017
3207,When Larry Meets Mary,27863090,0,0.0,27863090,1.0,2016
3208,Dark Skies,27858103,17418667,0.6252639312877837,10439436,0.3747360687122163,2013
3209,Manual of Love 2,27833482,0,0.0,27833482,1.0,2007
3210,The Lady Shogun and Her Men,27769952,0,0.0,27769952,1.0,2010
3211,Love & Basketball,27728118,27459615,0.9903165804473278,268503,0.009683419552672129,2000
3212,Ruby & Quentin,27720972,312824,0.011284741386413145,27408148,0.9887152586135869,2003
3213,Appaloosa,27712362,20211394,0.7293277274596802,7500968,0.2706722725403197,2008
3214,Love Strikes!,27707149,0,0.0,27707149,1.0,2011
3215,Recep Ivedik 2,27699692,0,0.0,27699692,1.0,2009
3216,Kim Ji-young: Born 1982,27696393,0,0.0,27696393,1.0,2019
3217,Default,27694043,203775,0.007358080580722721,27490268,0.9926419194192773,2018
3218,Dirty Dancing: Havana Nights,27685016,14161590,0.5115254403320554,13523426,0.48847455966794456,2004
3219,Nebraska,27682872,17654912,0.6377557935462765,10027960,0.36224420645372346,2013
3220,Traitor,27674464,23530831,0.8502723304776563,4143633,0.1497276695223438,2008
3221,The Quiet American,27674124,12988801,0.46934822580111296,14685323,0.530651774198887,2002
3222,Bride Wars,27670000,0,0.0,27670000,1.0,2015
3223,Ice Princess,27645491,24402491,0.882693347714461,3243000,0.11730665228553908,2005
3224,The Last Castle,27642707,18244060,0.659995419406645,9398647,0.34000458059335503,2001
3225,The Road,27639579,8117000,0.29367306933293014,19522579,0.7063269306670699,2009
3226,Pokémon Ranger and the Temple of the Sea,27638625,0,0.0,27638625,1.0,2006
3227,Goal! The Dream Begins,27610873,4283255,0.15512928548112187,23327618,0.8448707145188781,2005
3228,One Cut of the Dead,27590180,52406,0.0018994439325876091,27537774,0.9981005560674124,2018
3229,Nicholas on Holiday,27567832,0,0.0,27567832,1.0,2014
3230,Cirque du Soleil: Journey of Man,27538359,15627434,0.5674787666178657,11910925,0.43252123338213433,2000
3231,The Women on the 6th Floor,27533970,719823,0.026143087974600104,26814147,0.9738569120253999,2011
3232,Grace of Monaco,27515247,0,0.0,27515247,1.0,2014
3233,The Happytime Murders,27506452,20706452,0.7527852737968532,6800000,0.2472147262031468,2018
3234,The Incredible Burt Wonderstone,27437881,22537881,0.8214147805364416,4900000,0.17858521946355843,2013
3235,Frost/Nixon,27426335,18622031,0.678983575457676,8804304,0.321016424542324,2008
3236,Yesterday Once More,27411872,0,0.0,27411872,1.0,2016
3237,Left Behind,27405896,14019924,0.5115659783573578,13385972,0.48843402164264216,2014
3238,Irrational Man,27391084,4030360,0.14714131065422603,23360724,0.852858689345774,2015
3239,Legend of the Fist: The Return of Chen Zhen,27390678,50433,0.0018412468650830767,27340245,0.998158753134917,2010
3240,Ella Enchanted,27388767,22918387,0.8367805312301938,4470380,0.16321946876980625,2004
3241,Detective K: Secret of the Lost Island,27387870,185367,0.006768215271943382,27202503,0.9932317847280566,2015
3242,Gorko!,27369902,0,0.0,27369902,1.0,2013
3243,Midnight Sun,27365467,9561064,0.34938428056060583,17804403,0.6506157194393942,2018
3244,Pokémon: Mewtwo Strikes Back - Evolution,27347118,0,0.0,27347118,1.0,2019
3245,The Last Mimzy,27308918,21471047,0.7862284034834335,5837871,0.2137715965165665,2007
3246,Dororo,27308865,0,0.0,27308865,1.0,2007
3247,Stay Alive,27298695,23086480,0.8456990343311283,4212215,0.15430096566887172,2006
3248,Ramona and Beezus,27293743,26167002,0.9587179742990912,1126741,0.04128202570090881,2010
3249,To the Fore,27267799,0,0.0,27267799,1.0,2015
3250,American Ultra,27262374,14440985,0.5297038695162791,12821389,0.4702961304837209,2015
3251,Forever the Moment,27259300,0,0.0,27259300,1.0,2008
3252,Public Enemy 3,27226420,0,0.0,27226420,1.0,2008
3253,VIP Policeman,27222681,0,0.0,27222681,1.0,2018
3254,Sorority Row,27206120,11965282,0.4398011182777993,15240838,0.5601988817222008,2009
3255,Khumba,27187375,1029,3.7848449877930475e-05,27186346,0.999962151550122,2013
3256,The Protector,27165581,12044087,0.44335834378068334,15121494,0.5566416562193166,2005
3257,Splice 2010 Re-release,27127620,17010170,0.627042475528631,10117450,0.37295752447136904,2010
3258,Shoot 'Em Up,27122238,12807139,0.47220067164074,14315099,0.52779932835926,2007
3259,Let Me In,27093592,12134935,0.4478894861928976,14958657,0.5521105138071024,2010
3260,Ghost Town,27090159,13367624,0.4934494478234698,13722535,0.5065505521765302,2008
3261,Joy of Fatherhood,27088817,0,0.0,27088817,1.0,2014
3262,My Neighbor Totoro 2018 Re-release,27083857,1144649,0.042263145902741994,25939208,0.9577368540972581,2018
3263,Rendition,27066382,9736045,0.3597098792147395,17330337,0.6402901207852605,2007
3264,Hitchcock,27039669,6008677,0.22221710628188532,21030992,0.7777828937181147,2012
3265,The Crime of Padre Amaro,26996738,5717044,0.21176795507664667,21279694,0.7882320449233533,2002
3266,Almost a Comedy,26990962,0,0.0,26990962,1.0,2019
3267,Clerks II,26984975,24148068,0.8948708679552232,2836907,0.10512913204477677,2006
3268,Observe and Report,26973554,24007324,0.8900319179296877,2966230,0.10996808207031228,2009
3269,The Baader Meinhof Complex,26937355,476270,0.017680652016502735,26461085,0.9823193479834973,2008
3270,Letters to Santa,26923513,0,0.0,26923513,1.0,2011
3271,Total Dhamaal,26911995,2167632,0.08054519926895051,24744363,0.9194548007310495,2019
3272,The Painted Veil,26910847,8060487,0.2995255779203085,18850360,0.7004744220796915,2006
3273,The Witches,26900000,0,0.0,26900000,1.0,2020
3274,You're Next,26895481,18494006,0.6876250326216512,8401475,0.3123749673783488,2013
3275,The In-Laws,26891849,20453431,0.7605810593388354,6438418,0.23941894066116465,2003
3276,Jodhaa Akbar,26890354,3440718,0.12795361489104978,23449636,0.8720463851089503,2008
3277,Mr. Go,26835201,0,0.0,26835201,1.0,2013
3278,The Invisible,26810113,20578909,0.7675800918854762,6231204,0.2324199081145238,2007
3279,CHIPS,26800152,18600152,0.6940315860895118,8200000,0.3059684139104883,2017
3280,The Faces of My Gene,26796279,0,0.0,26796279,1.0,2018
3281,Black Book,26768563,4398532,0.16431707596705883,22370031,0.8356829240329412,2006
3282,Dearest,26723916,0,0.0,26723916,1.0,2012
3283,Doogal,26711924,7438000,0.27845242446781443,19273924,0.7215475755321855,2005
3284,Doraemon: Nobita in the Wan-Nyan Spacetime Odyssey,26663978,0,0.0,26663978,1.0,2004
3285,Architecture 101,26642354,0,0.0,26642354,1.0,2012
3286,A Cure for Wellness,26620002,8106986,0.3045449057441844,18513016,0.6954550942558156,2017
3287,A Monster in Paris,26611650,0,0.0,26611650,1.0,2011
3288,Missing Link,26565710,16649539,0.626730435587831,9916171,0.3732695644121689,2019
3289,Mongol: The Rise of Genghis Khan,26527510,5705761,0.215088449688644,20821749,0.7849115503113561,2007
3290,No Manches Frida 2,26493648,9270920,0.3499299152762957,17222728,0.6500700847237043,2019
3291,A Hard Day,26488847,19004,0.0007174340204388662,26469843,0.9992825659795611,2014
3292,The Break Up Man,26477012,0,0.0,26477012,1.0,2013
3293,The Way Way Back,26474920,21506546,0.8123365811870253,4968374,0.18766341881297469,2013
3294,Chaos Walking,26456630,13287908,0.5022524788682459,13168722,0.49774752113175413,2021
3295,We Are the Nobles,26433651,0,0.0,26433651,1.0,2013
3296,Ivan Tsarevich & the Grey Wolf,26420475,0,0.0,26420475,1.0,2011
3297,Mad Money,26412163,20668843,0.7825501834136038,5743320,0.2174498165863962,2008
3298,Dancing Queen,26411266,0,0.0,26411266,1.0,2012
3299,Emma.,26404660,10055355,0.3808174390429568,16349305,0.6191825609570432,2020
3300,Center Stage,26385941,17200925,0.65189734942559,9185016,0.3481026505744101,2000
3301,Only the Brave,26351322,18343983,0.6961314123063731,8007339,0.3038685876936269,2017
3302,Saving Grace,26330482,12178602,0.46252863886046597,14151880,0.537471361139534,2000
3303,All About the Benjamins,26306533,25916319,0.9851666504286216,390214,0.014833349571378334,2002
3304,Twenty Two,26289378,46796,0.0017800345067121785,26242582,0.9982199654932878,2017
3305,Orange,26261536,0,0.0,26261536,1.0,2015
3306,Detective Conan: The Private Eyes' Requiem,26251232,0,0.0,26251232,1.0,2006
3307,Aloha,26250020,21067116,0.8025561885286182,5182904,0.19744381147138174,2015
3308,The Stolen Years,26249553,0,0.0,26249553,1.0,2013
3309,Apollo 18,26236153,17687709,0.6741731152429246,8548444,0.3258268847570755,2011
3310,The Confidence Man JP,26228317,0,0.0,26228317,1.0,2019
3311,One Night Surprise,26220159,0,0.0,26220159,1.0,2013
3312,Typhoon,26179656,139059,0.005311719909535863,26040597,0.9946882800904642,2005
3313,The Whole Ten Yards,26170671,16328471,0.6239225199842985,9842200,0.37607748001570157,2004
3314,Lesson of the Evil,26167224,0,0.0,26167224,1.0,2012
3315,The Zookeeper's Wife,26152835,17571660,0.6718835644395722,8581175,0.32811643556042774,2017
3316,9th Company,26146165,0,0.0,26146165,1.0,2005
3317,Badrinath Ki Dulhania,26134309,1993259,0.0762698183449197,24141050,0.9237301816550803,2017
3318,Badhaai Ho,26125610,0,0.0,26125610,1.0,2018
3319,Top Five,26117471,25317471,0.9693691628871723,800000,0.030630837112827655,2014
3320,An Education,26096852,12574914,0.48185558932548644,13521938,0.5181444106745136,2009
3321,Saving Silverman,26086706,19402030,0.7437516258281134,6684676,0.2562483741718866,2001
3322,Hichki,26055222,330279,0.012676115367583512,25724943,0.9873238846324165,2018
3323,Platinum Data,26052718,0,0.0,26052718,1.0,2013
3324,Iceman,26033917,7679,0.0002949613767302093,26026238,0.9997050386232698,2014
3325,Bratz,26013153,10010209,0.38481336729922744,16002944,0.6151866327007726,2007
3326,Agneepath,26001696,1986748,0.07640840043664844,24014948,0.9235915995633516,2012
3327,A Prairie Home Companion,25978867,20342852,0.783053856813694,5636015,0.216946143186306,2006
3328,The Light Between Oceans,25975621,12545979,0.48299053177592943,13429642,0.5170094682240706,2016
3329,A Chinese Odyssey: Part 2 - Cinderella 2017 Re-release,25960664,0,0.0,25960664,1.0,2017
3330,Love Off the Cuff,25959989,0,0.0,25959989,1.0,2017
3331,The Confidence Man JP: The Movie,25958189,0,0.0,25958189,1.0,2019
3332,White Boy Rick,25957482,24011188,0.925019922964793,1946294,0.07498007703520704,2018
3333,Meet Miss Anxiety,25948636,0,0.0,25948636,1.0,2014
3334,"Paul, Apostle of Christ",25915966,17560475,0.6775929170458087,8355491,0.32240708295419124,2018
3335,Huevos: Little Rooster's Egg-cellent Adventure,25892561,9080818,0.3507114649647827,16811743,0.6492885350352172,2015
3336,Gekijouban SPEC: Kurôzu - Zen no hen,25860404,0,0.0,25860404,1.0,2013
3337,Rollerball,25852764,18990798,0.7345751502624632,6861966,0.26542484973753677,2002
3338,Boys and Girls,25850615,21799652,0.8432933607188843,4050963,0.15670663928111575,2000
3339,Dügün Dernek 2: Sünnet,25836668,0,0.0,25836668,1.0,2015
3340,The Alamo,25819961,22414961,0.8681252849297487,3405000,0.13187471507025128,2004
3341,Leap,25818882,83074,0.00321756767004861,25735808,0.9967824323299513,2020
3342,Unbeatable,25816154,0,0.0,25816154,1.0,2013
3343,Rust and Bone,25807712,2062027,0.07989964395138942,23745685,0.9201003560486106,2012
3344,Our Idiot Brother,25804448,24816118,0.9616992388289026,988330,0.038300761171097326,2011
3345,Fair Game,25798915,9540691,0.3698097768840279,16258224,0.6301902231159722,2010
3346,"The Gangster, the Cop, the Devil",25775371,216494,0.008399258346271718,25558877,0.9916007416537282,2019
3347,Man on the Edge,25774679,0,0.0,25774679,1.0,2013
3348,Scoob!,25750000,850000,0.03300970873786408,24900000,0.9669902912621359,2020
3349,RocknRolla,25740863,5700626,0.22146211647993308,20040237,0.7785378835200669,2008
3350,A Beautiful Planet,25730120,15650615,0.6082604744944835,10079505,0.3917395255055165,2016
3351,Champions,25702837,0,0.0,25702837,1.0,2018
3352,Fireworks,25672406,525280,0.020460879280266915,25147126,0.979539120719733,2017
3353,Natale a Miami,25643184,0,0.0,25643184,1.0,2005
3354,The Roundup,25623521,0,0.0,25623521,1.0,2010
3355,Jonah: A VeggieTales Movie,25615231,25581229,0.9986725866341006,34002,0.0013274133658993745,2002
3356,Father Figures,25601244,17501244,0.6836091246191005,8100000,0.31639087538089944,2017
3357,Coco,25593707,0,0.0,25593707,1.0,2009
3358,"Love, Rosie",25574387,20431,0.0007988852284123173,25553956,0.9992011147715877,2014
3359,Mr. Donkey,25537759,356255,0.013950127730471574,25181504,0.9860498722695284,2016
3360,Look Who's Back,25513752,0,0.0,25513752,1.0,2015
3361,The Tiger and the Snow,25460023,10167,0.00039933192519111236,25449856,0.9996006680748089,2005
3362,Doraemon the Movie: The New Records of Nobita's Spaceblazer,25422212,0,0.0,25422212,1.0,2009
3363,Grindhouse,25422088,25037897,0.9848875119935073,384191,0.015112488006492621,2007
3364,Money,25403753,0,0.0,25403753,1.0,2017
3365,Head Over Heels 2,25402893,0,0.0,25402893,1.0,2012
3366,The Hitcher,25399945,16472961,0.6485431759793181,8926984,0.35145682402068196,2007
3367,In America,25382911,15539656,0.6122093718880391,9843255,0.38779062811196086,2003
3368,Keys To The Heart,25375866,75134,0.0029608447648643795,25300732,0.9970391552351356,2018
3369,Serial Teachers 2,25364150,0,0.0,25364150,1.0,2015
3370,Natale in Sudafrica,25362517,0,0.0,25362517,1.0,2010
3371,A Haunted House 2,25358716,17329486,0.6833739531607199,8029230,0.31662604683928003,2014
3372,You Are So Beautiful,25329576,0,0.0,25329576,1.0,2006
3373,And So It Goes,25312387,15160801,0.5989478985130877,10151586,0.40105210148691234,2014
3374,The Last Legion,25303038,5933494,0.23449729633255895,19369544,0.765502703667441,2007
3375,Nada sô sô,25300338,0,0.0,25300338,1.0,2006
3376,Bodies at Rest,25293853,0,0.0,25293853,1.0,2019
3377,Enough Said,25288872,17550872,0.6940156128751017,7738000,0.3059843871248983,2013
3378,Corky Romano,25272752,23980304,0.9488600212592597,1292448,0.05113997874074022,2001
3379,Kabhi Alvida Naa Kehna,25229168,3275444,0.12982766613627528,21953724,0.8701723338637247,2006
3380,I'm a Cat Stalker,25221446,0,0.0,25221446,1.0,2008
3381,North Country,25211175,18337722,0.7273648292870126,6873453,0.2726351707129874,2005
3382,Biutiful,25147786,5101237,0.20285034237208793,20046549,0.797149657627912,2010
3383,Mt. Tsurugidake,25134437,0,0.0,25134437,1.0,2009
3384,On the Other Side of the Tracks,25109572,9572,0.0003812092057961004,25100000,0.9996187907942039,2012
3385,Born in China,25081168,13873211,0.5531325734112542,11207957,0.4468674265887458,2016
3386,Race,25070261,19206207,0.7660952153629353,5864054,0.2339047846370646,2016
3387,Herutâ sukerutâ,25066699,0,0.0,25066699,1.0,2012
3388,The Last Exorcism Part II,25051865,15179302,0.6059150486400913,9872563,0.39408495135990873,2013
3389,Call of Heroes,25040561,0,0.0,25040561,1.0,2016
3390,Before the Devil Knows You're Dead,25037657,7084227,0.2829428887854802,17953430,0.7170571112145198,2007
3391,Free State of Jones,25035950,20810036,0.8312061655339622,4225914,0.16879383446603785,2016
3392,Six Degrees of Celebration,25030264,0,0.0,25030264,1.0,2010
3393,The Last Tycoon,25009914,0,0.0,25009914,1.0,2012
3394,Georgia Rule,25000167,19103072,0.7641177756932583,5897095,0.23588222430674163,2007
3395,"Me, Myself and Mum",24991467,0,0.0,24991467,1.0,2013
3396,Whiskey Tango Foxtrot,24972139,23083334,0.924363507667485,1888805,0.07563649233251504,2016
3397,A Single Man,24964890,9176000,0.36755619592155225,15788890,0.6324438040784478,2009
3398,Booksmart,24959607,22680962,0.9087066955821861,2278645,0.09129330441781396,2019
3399,The Way Home,24952738,445367,0.017848422084983218,24507371,0.9821515779150167,2002
3400,Housefull 2,24922847,1791780,0.07189307064317331,23131067,0.9281069293568267,2012
3401,April Snow,24873159,0,0.0,24873159,1.0,2005
3402,Seed of Chucky,24829644,17083732,0.6880377342502373,7745912,0.31196226574976266,2004
3403,Wild City,24817852,34866,0.0014048758127818636,24782986,0.9985951241872182,2015
3404,The Miracle of Bern,24816394,0,0.0,24816394,1.0,2003
3405,Elle s'appelait Sarah,24792815,7693187,0.31029905236658284,17099628,0.6897009476334172,2010
3406,Eyyvah Eyvah 2,24792348,0,0.0,24792348,1.0,2011
3407,The Courier,24763612,6613432,0.2670624947604574,18150180,0.7329375052395426,2021
3408,Lottery Ticket,24719879,24719879,1.0,0,0.0,2010
3409,Big Miracle,24719215,20157300,0.815450652458017,4561915,0.18454934754198302,2012
3410,Bride & Prejudice,24716440,6605592,0.26725499303297723,18110848,0.7327450069670227,2004
3411,Kaiji: Jinsei gyakuten gêmu,24709016,0,0.0,24709016,1.0,2009
3412,Super 30,24701637,2269878,0.09189180457959123,22431759,0.9081081954204088,2019
3413,The Shipping News,24690441,11434216,0.4631029474119154,13256225,0.5368970525880846,2001
3414,Soulmate,24684439,0,0.0,24684439,1.0,2016
3415,Drug War,24676341,128195,0.005195057079167451,24548146,0.9948049429208325,2013
3416,Punch-Drunk Love,24665649,17844216,0.7234440091156734,6821433,0.27655599088432664,2002
3417,Ready,24663361,955148,0.03872740621199195,23708213,0.961272593788008,2011
3418,Liar Game: The Final Stage,24658706,0,0.0,24658706,1.0,2010
3419,The Death of Stalin,24646055,8047856,0.32653728963925466,16598199,0.6734627103607453,2017
3420,The Snow Queen 3: Fire and Ice,24644317,0,0.0,24644317,1.0,2016
3421,Sparkle,24637800,24397469,0.9902454358749564,240331,0.009754564125043632,2012
3422,The Players,24629152,10854,0.00044069726801799754,24618298,0.999559302731982,2012
3423,Liar Game: Reborn,24549726,0,0.0,24549726,1.0,2012
3424,Joe Somebody,24516772,22771646,0.9288190957602412,1745126,0.07118090423975881,2001
3425,Podium,24511116,0,0.0,24511116,1.0,2004
3426,Race,24503269,1367024,0.05578945405202873,23136245,0.9442105459479713,2008
3427,God's Not Dead 2,24487848,20774575,0.8483626245964937,3713273,0.15163737540350627,2016
3428,The Tale of The Princess Kaguya,24434485,703232,0.028780307831329368,23731253,0.9712196921686707,2013
3429,The 8-Year Engagement,24425963,0,0.0,24425963,1.0,2017
3430,Stan & Ollie,24420923,5470235,0.22399788083357866,18950688,0.7760021191664214,2018
3431,Down to You,24419914,20069008,0.8218295936668737,4350906,0.1781704063331263,2000
3432,If I Were You 2,24415116,0,0.0,24415116,1.0,2009
3433,Skyfire,24375211,1105,4.533294091279866e-05,24374106,0.9999546670590872,2019
3434,The Next Best Thing,24362772,14990582,0.61530691170939,9372190,0.38469308829060994,2000
3435,Detective Conan: Crossroad in the Ancient Capital,24342320,0,0.0,24342320,1.0,2003
3436,The Witch: Part 1 - The Subversion,24340302,0,0.0,24340302,1.0,2018
3437,Nowhere in Africa,24322180,6180200,0.25409728897656375,18141980,0.7459027110234362,2001
3438,Tanguy,24272365,0,0.0,24272365,1.0,2001
3439,The Great Beauty,24271739,2852400,0.11751939158541545,21419339,0.8824806084145845,2013
3440,Trance,24261569,2328743,0.09598484747626998,21932826,0.90401515252373,2013
3441,The Accidental Detective 2: In Action,24243825,179045,0.0073851795250955655,24064780,0.9926148204749045,2018
3442,Camping 3,24224579,0,0.0,24224579,1.0,2016
3443,Jolly LLB 2,24214186,1654254,0.06831755566757437,22559932,0.9316824443324256,2017
3444,The Railway Man,24174885,4438438,0.18359706778336277,19736447,0.8164029322166372,2013
3445,The Way Back,24172201,2701859,0.11177546471668012,21470342,0.8882245352833199,2010
3446,The Guru,24128852,3095506,0.12829064557236292,21033346,0.8717093544276371,2002
3447,The Founder,24121245,12786053,0.5300743390318369,11335192,0.46992566096816313,2016
3448,Out of Inferno,24109886,0,0.0,24109886,1.0,2013
3449,Guru,24108727,2096000,0.08693947216707046,22012727,0.9130605278329296,2007
3450,Start-Up,24106579,0,0.0,24106579,1.0,2019
3451,Bad Santa 2,24079268,17782178,0.7384849904905747,6297090,0.2615150095094253,2016
3452,Kung Fu Jungle,24070765,129784,0.0053917688116684286,23940981,0.9946082311883315,2014
3453,I Give My First Love to You,24051386,0,0.0,24051386,1.0,2009
3454,I Can Speak,24024444,63239,0.0026322773588433514,23961205,0.9973677226411567,2017
3455,Nasha Russia. Yaytsa sudby,24022125,0,0.0,24022125,1.0,2010
3456,Dark Water,24010000,0,0.0,24010000,1.0,2002
3457,Bring Happiness Home,23980000,0,0.0,23980000,1.0,2013
3458,Partner,23968620,1062840,0.04434297844431594,22905780,0.9556570215556841,2007
3459,I Want You,23961214,0,0.0,23961214,1.0,2012
3460,Türkisch für Anfänger,23952712,0,0.0,23952712,1.0,2012
3461,School for Scoundrels,23947685,17807569,0.7436029411611185,6140116,0.25639705883888153,2006
3462,I Love You in Every Language in the World,23941317,0,0.0,23941317,1.0,2005
3463,Stormbreaker,23937870,677646,0.028308533716659,23260224,0.971691466283341,2006
3464,Harold & Kumar Go to White Castle,23936908,18250550,0.7624439213285191,5686358,0.23755607867148087,2004
3465,Killing for the Prosecution,23929620,0,0.0,23929620,1.0,2018
3466,25th Hour,23928503,13084595,0.5468204592656716,10843908,0.4531795407343284,2002
3467,Birth,23925492,5095038,0.21295436683182942,18830454,0.7870456331681706,2004
3468,Mortadelo & Filemon: The Big Adventure,23920411,0,0.0,23920411,1.0,2003
3469,Sex Is Zero,23915279,0,0.0,23915279,1.0,2002
3470,Mao's Last Dancer,23914731,4817770,0.20145616523974283,19096961,0.7985438347602571,2009
3471,Life as a House,23903791,15667270,0.6554303457556168,8236521,0.34456965424438324,2001
3472,Pinocchio,23887762,1831718,0.07668018460666177,22056044,0.9233198153933382,2019
3473,Spirits' Homecoming,23857217,125616,0.0052653249538703525,23731601,0.9947346750461297,2016
3474,Silence,23834809,7100177,0.2978910802264033,16734632,0.7021089197735967,2016
3475,Lady Vengeance,23834149,211667,0.00888082893163083,23622482,0.9911191710683692,2005
3476,Eight Crazy Nights,23833131,23586598,0.9896558702253598,246533,0.010344129774640184,2002
3477,Wanderlust,23812816,17450535,0.7328211413551425,6362281,0.26717885864485746,2012
3478,Detective Conan: The Phantom of Baker Street,23786606,0,0.0,23786606,1.0,2002
3479,"Little Brother, Big Trouble: A Christmas Adventure",23785681,0,0.0,23785681,1.0,2012
3480,Dark Planet,23772559,0,0.0,23772559,1.0,2009
3481,Interstellar 2020 Re-release,23771122,0,0.0,23771122,1.0,2020
3482,Dickie Roberts: Former Child Star,23769505,22738671,0.9566320796331266,1030834,0.04336792036687344,2003
3483,Detroit Metal City,23744571,0,0.0,23744571,1.0,2008
3484,The Peanut Butter Falcon,23743627,20457151,0.8615849212927746,3286476,0.1384150787072253,2019
3485,Pokémon the Movie: The Power of Us,23740788,789170,0.0332411038757433,22951618,0.9667588961242567,2018
3486,Russian Dolls,23727301,326095,0.013743451056654105,23401206,0.9862565489433459,2005
3487,In the Cut,23726793,4750602,0.20022099067497237,18976191,0.7997790093250277,2003
3488,Il mio miglior nemico,23710143,0,0.0,23710143,1.0,2006
3489,Da Xiao Jiang Hu,23705022,0,0.0,23705022,1.0,2010
3490,To the Arctic 3D,23695388,14560838,0.6145009315736886,9134550,0.3854990684263115,2012
3491,The Glass House,23619609,18150259,0.7684402819707981,5469350,0.23155971802920192,2001
3492,Little White Lies 2,23613535,0,0.0,23613535,1.0,2019
3493,Kevin Hart: What Now?,23591043,23591043,1.0,0,0.0,2016
3494,Hustle & Flow,23563727,22202809,0.9422452144348812,1360918,0.057754785565118795,2005
3495,No manches Frida,23540937,11528613,0.48972617360133114,12012324,0.5102738263986688,2016
3496,Disco,23524551,0,0.0,23524551,1.0,2008
3497,Biker Boyz,23510621,22076772,0.9390127125948736,1433849,0.06098728740512639,2003
3498,Wish Upon,23468586,14301505,0.6093892917110558,9167081,0.39061070828894423,2017
3499,Valley of the Wolves: Iraq,23465471,0,0.0,23465471,1.0,2006
3500,Tomcats,23430766,13558739,0.5786724599614029,9872027,0.4213275400385971,2001
3501,Act of Vengeance,23423390,0,0.0,23423390,1.0,2010
3502,Ossan's Love: Love or Dead,23422744,0,0.0,23422744,1.0,2019
3503,Only Cloud Knows,23410836,0,0.0,23410836,1.0,2019
3504,Those Who Wish Me Dead,23408489,7347103,0.3138648974737327,16061386,0.6861351025262673,2021
3505,Kingdom Come,23396049,23249649,0.9937425331943868,146400,0.006257466805613204,2001
3506,In His Chart,23384864,0,0.0,23384864,1.0,2011
3507,Antwone Fisher,23367586,21078145,0.9020249246113826,2289441,0.09797507538861738,2002
3508,The Father,23366855,2122771,0.09084538762276738,21244084,0.9091546123772326,2020
3509,Detroit,23355100,16790139,0.7189067484189748,6564961,0.2810932515810251,2017
3510,Paris,23328518,1010194,0.04330296506619066,22318324,0.9566970349338093,2008
3511,Captain Alatriste: The Spanish Musketeer,23321954,0,0.0,23321954,1.0,2006
3512,Middle School: The Worst Years of My Life,23316139,20007149,0.8580815631610362,3308990,0.14191843683896377,2016
3513,Under the Same Moon,23313049,12590147,0.5400472070384272,10722902,0.4599527929615727,2008
3514,Warrior,23308615,13657115,0.5859256330760108,9651500,0.41407436692398925,2011
3515,Ali G Indahouse,23280529,0,0.0,23280529,1.0,2002
3516,Yomigaeri,23259542,0,0.0,23259542,1.0,2003
3517,"Sorry, If I Love You",23249815,0,0.0,23249815,1.0,2008
3518,Another Public Enemy,23248003,0,0.0,23248003,1.0,2005
3519,Jonas Brothers: The 3D Concert Experience,23186960,19162740,0.8264446913265042,4024220,0.1735553086734958,2009
3520,Super Troopers,23182223,18492362,0.7976958033748532,4689861,0.2023041966251468,2002
3521,Triple 9,23177948,12639297,0.5453156163781194,10538651,0.4546843836218806,2016
3522,Hoodwinked Too! Hood vs. Evil,23167844,10143779,0.4378387130023838,13024065,0.5621612869976161,2011
3523,Rock Dog,23157646,9420546,0.40680067395451164,13737100,0.5931993260454884,2016
3524,The Guernsey Literary and Potato Peel Pie Society,23148937,0,0.0,23148937,1.0,2018
3525,The Crimes That Bind,23144130,0,0.0,23144130,1.0,2018
3526,New Happy Dad and Son 3: Adventure in Russia,23130469,0,0.0,23130469,1.0,2018
3527,Dark Waters,23108017,11136084,0.48191430705629135,11971933,0.5180856929437087,2019
3528,The Farewell,23076657,17695781,0.7668260181706562,5380876,0.23317398182934382,2019
3529,The Choice,23064015,18730891,0.8121262061267304,4333124,0.1878737938732697,2016
3530,"OSS 117: Cairo, Nest of Spies",23055884,303543,0.013165532928600785,22752341,0.9868344670713992,2006
3531,"The Legend of Al, John and Jack",23039985,0,0.0,23039985,1.0,2002
3532,Confidence,23014206,12251640,0.5323511921288964,10762566,0.46764880787110363,2003
3533,Under the Hawthorn Tree,23004431,0,0.0,23004431,1.0,2010
3534,Detective Conan: Full Score of Fear,22996756,0,0.0,22996756,1.0,2008
3535,Padmaavat,22991060,11846060,0.5152463609768319,11145000,0.48475363902316815,2018
3536,Aquamarine,22989957,18597342,0.8089333094446414,4392615,0.19106669055535858,2006
3537,The Marksman,22988549,15566093,0.677123771491624,7422456,0.32287622850837605,2021
3538,Imagine That,22985194,16123323,0.7014656043364264,6861871,0.2985343956635737,2009
3539,Hotaru the Movie: It's Only a Little Light in My Life,22975341,0,0.0,22975341,1.0,2012
3540,Days of Glory,22963701,320700,0.013965518885653493,22643001,0.9860344811143466,2006
3541,Penny Pincher!,22955486,0,0.0,22955486,1.0,2016
3542,The Human Stain,22954068,5381908,0.23446423527193525,17572160,0.7655357647280647,2003
3543,Kung Fu Dunk,22945567,0,0.0,22945567,1.0,2008
3544,Domino,22944502,10169202,0.4432086606194373,12775300,0.5567913393805627,2005
3545,Armored,22942221,15988876,0.6969192738575747,6953345,0.30308072614242537,2009
3546,Young Adult,22939027,16311571,0.7110838223434673,6627456,0.28891617765653266,2011
3547,A Perfect Getaway,22938329,15515460,0.6763988780525382,7422869,0.3236011219474618,2009
3548,Andalucia: Revenge of the Goddess,22929221,0,0.0,22929221,1.0,2011
3549,A Separation,22926076,7099055,0.30964980662194436,15827021,0.6903501933780556,2011
3550,Hot Road,22916313,0,0.0,22916313,1.0,2014
3551,The Wind that Shakes the Barley,22899908,1836089,0.08017888106799381,21063819,0.9198211189320062,2006
3552,Dorian Gray,22873653,0,0.0,22873653,1.0,2009
3553,The Merry Widow,22872698,0,0.0,22872698,1.0,2008
3554,Baggage Claim,22871096,21569509,0.9430903092707057,1301587,0.056909690729294304,2013
3555,Qualunquemente,22862029,0,0.0,22862029,1.0,2011
3556,Won't You Be My Neighbor?,22844741,22835787,0.9996080498351897,8954,0.0003919501648103605,2018
3557,Dr. T & the Women,22844291,13113041,0.5740182962999377,9731250,0.42598170370006233,2000
3558,Kon-Tiki,22842887,1517410,0.06642811830220935,21325477,0.9335718816977907,2012
3559,The Ruins,22818256,17432844,0.763986695565165,5385412,0.23601330443483498,2008
3560,Persepolis,22783978,4445756,0.19512641734467967,18338222,0.8048735826553204,2007
3561,The Knight of Shadows: Between Yin and Yang,22774256,0,0.0,22774256,1.0,2019
3562,Extraordinary Mission,22757764,54174,0.0023804623336457836,22703590,0.9976195376663543,2017
3563,Black and Blue,22741061,22055313,0.9698453823240701,685748,0.030154617675929897,2019
3564,U2,22730842,10363341,0.4559154033977272,12367501,0.5440845966022728,2008
3565,The Accidental Husband,22707064,0,0.0,22707064,1.0,2008
3566,Fading Gigolo,22706304,3769873,0.1660275930420028,18936431,0.8339724069579972,2014
3567,Cassandra's Dream,22686378,973018,0.04288996683384188,21713360,0.9571100331661582,2007
3568,Paco and the Magical Book,22679633,0,0.0,22679633,1.0,2008
3569,Christmas in Love,22668087,0,0.0,22668087,1.0,2004
3570,Fall in Love Like a Star,22640355,0,0.0,22640355,1.0,2012
3571,The White Massai,22632255,0,0.0,22632255,1.0,2005
3572,Detective Conan: Magician of the Silver Sky,22618511,0,0.0,22618511,1.0,2004
3573,EuroTrip,22605153,17771387,0.7861653048753973,4833766,0.2138346951246028,2004
3574,The Banquet,22598772,0,0.0,22598772,1.0,2006
3575,Recep Ivedik 3,22588876,0,0.0,22588876,1.0,2010
3576,Friends: Naki on the Monster Island,22537428,0,0.0,22537428,1.0,2011
3577,Asterix and the Vikings,22501596,0,0.0,22501596,1.0,2006
3578,The Day We Lit Up the Sky,22500000,0,0.0,22500000,1.0,2021
3579,Doomsday,22472631,11008770,0.48987455006937103,11463861,0.5101254499306289,2008
3580,Swimming Pool,22441497,10130108,0.45140072429214506,12311389,0.5485992757078549,2003
3581,Europe Raiders,22435156,0,0.0,22435156,1.0,2018
3582,Men in the City,22420615,0,0.0,22420615,1.0,2009
3583,Villain,22414467,0,0.0,22414467,1.0,2010
3584,Two Can Play That Game,22391450,22235901,0.9930531966442548,155549,0.006946803355745161,2001
3585,Late Night,22386555,15499454,0.6923554785450463,6887101,0.30764452145495363,2019
3586,Dead Silence,22382047,16809076,0.7510070906383138,5572971,0.24899290936168617,2007
3587,Mojin: The Worm Valley,22381583,101516,0.004535693476194244,22280067,0.9954643065238058,2018
3588,The Contender,22361811,17872723,0.7992520373238107,4489088,0.20074796267618933,2000
3589,Kamen Rider OOO Wonderful: The Shogun and the 21 Core Medals,22313925,0,0.0,22313925,1.0,2011
3590,Quill: The Life of a Guide Dog,22298559,0,0.0,22298559,1.0,2004
3591,Chouchou,22288364,0,0.0,22288364,1.0,2003
3592,I've Loved You So Long,22272176,3169305,0.1422988485723173,19102871,0.8577011514276827,2008
3593,NASCAR: The IMAX Experience,22248831,21583831,0.970110789191576,665000,0.029889210808424046,2004
3594,Neuilly Yo Mama!,22243482,0,0.0,22243482,1.0,2009
3595,Reign Over Me,22242388,19661987,0.8839872319464979,2580401,0.11601276805350216,2007
3596,Waitress,22240529,19074800,0.8576594558519719,3165729,0.14234054414802813,2007
3597,A.R.O.G,22212369,0,0.0,22212369,1.0,2008
3598,Gooische vrouwen,22194574,0,0.0,22194574,1.0,2011
3599,Upside Down,22187813,105095,0.004736609236791386,22082718,0.9952633907632086,2012
3600,Fanaa,22175908,2105352,0.09493870555379288,20070556,0.9050612944462071,2006
3601,The Marine,22165608,18844784,0.8501812357233783,3320824,0.1498187642766217,2006
3602,Ghosts of the Abyss,22141539,17040871,0.7696335381203628,5100668,0.2303664618796372,2003
3603,Masquerade Night,22138941,0,0.0,22138941,1.0,2021
3604,Unbowed,22132903,0,0.0,22132903,1.0,2012
3605,Ip Man,22108789,0,0.0,22108789,1.0,2008
3606,The Glass Castle,22088533,17273059,0.7819921313923383,4815474,0.21800786860766172,2017
3607,Manual of Love,22079820,0,0.0,22079820,1.0,2005
3608,Stree,22075730,0,0.0,22075730,1.0,2018
3609,Gretel & Hansel,22051055,15347654,0.6960054292186927,6703401,0.3039945707813073,2020
3610,A Thousand Words,22044277,18450127,0.8369576829396582,3594150,0.16304231706034178,2010
3611,"Me, Them and Lara",22039646,0,0.0,22039646,1.0,2010
3612,Crows Zero,22036607,0,0.0,22036607,1.0,2007
3613,Little Black Book,22035509,20698668,0.9393324202313639,1336841,0.06066757976863616,2004
3614,Reno 911! Miami,22021262,20342161,0.9237509185440871,1679101,0.07624908145591293,2007
3615,My Blueberry Nights,22007671,867275,0.039407850108264524,21140396,0.9605921498917355,2007
3616,A Rainy Day in New York,22002504,0,0.0,22002504,1.0,2019
3617,Wild Child,21972336,0,0.0,21972336,1.0,2008
3618,Love Don't Cost a Thing,21964072,21924226,0.9981858555189584,39846,0.0018141444810415846,2003
3619,Unaccompanied Minors,21949234,16655224,0.7588066171238596,5294010,0.24119338287614045,2006
3620,Leap! 2017 Re-release,21929861,21858070,0.9967263358395204,71791,0.003273664160479631,2017
3621,Moss,21925534,0,0.0,21925534,1.0,2010
3622,OSS 117: Lost in Rio,21924245,89375,0.004076537185202957,21834870,0.995923462814797,2009
3623,Kaamelott: First Installment,21915275,188000,0.008578491485961275,21727275,0.9914215085140388,2021
3624,Unfair: The Movie,21914005,0,0.0,21914005,1.0,2007
3625,Like Stars on Earth,21897373,1223869,0.05589113360767065,20673504,0.9441088663923294,2007
3626,Flicka,21893591,21000147,0.9591915277854601,893444,0.04080847221453986,2006
3627,"Grande, grosso e... Verdone",21860130,0,0.0,21860130,1.0,2008
3628,The Immature,21858834,0,0.0,21858834,1.0,2011
3629,Do You Know Claudia?,21852972,0,0.0,21852972,1.0,2004
3630,Pleasant Goat and Big Big Wolf 3,21847806,0,0.0,21847806,1.0,2011
3631,Mr. 3000,21839377,21811187,0.9987092122637015,28190,0.0012907877362985218,2004
3632,Rob-B-Hood,21836580,0,0.0,21836580,1.0,2006
3633,Poupelle of Chimney Town,21824592,0,0.0,21824592,1.0,2020
3634,The Flight Before Christmas,21822495,0,0.0,21822495,1.0,2008
3635,The Barbarian Invasions 2003 Re-release,21815430,3435749,0.1574916928064219,18379681,0.8425083071935782,2003
3636,The Rebound,21791288,0,0.0,21791288,1.0,2009
3637,Phone,21784403,0,0.0,21784403,1.0,2002
3638,Torrente 3: El protector,21762391,0,0.0,21762391,1.0,2005
3639,Confession of Murder,21701525,0,0.0,21701525,1.0,2012
3640,22 Bullets,21695883,0,0.0,21695883,1.0,2010
3641,White Oleander,21672284,16357770,0.7547783150128523,5314514,0.24522168498714764,2002
3642,Inazuma Eleven GO the Movie: The Ultimate Bonds Gryphon,21645379,0,0.0,21645379,1.0,2010
3643,StreetDance 2 2012 Re-release,21638853,0,0.0,21638853,1.0,2012
3644,Just Wright,21584424,21540363,0.9979586668608807,44061,0.0020413331391192094,2010
3645,Man of the House,21577624,19699706,0.91296919438396,1877918,0.08703080561604003,2005
3646,Wolfhound,21573338,0,0.0,21573338,1.0,2006
3647,Épouse-moi mon pote,21571464,0,0.0,21571464,1.0,2017
3648,Wicker Park,21568818,13001257,0.6027802265288714,8567561,0.3972197734711286,2004
3649,Quick,21561934,0,0.0,21561934,1.0,2011
3650,2012 2012 Re-release,21538353,0,0.0,21538353,1.0,2012
3651,Win a Date with Tad Hamilton!,21513434,17071962,0.7935489053026124,4441472,0.20645109469738768,2004
3652,Black Christmas,21510851,16273581,0.7565289257965666,5237270,0.24347107420343342,2006
3653,Chak De! India,21505244,1120404,0.052099106617902124,20384840,0.9479008933820978,2007
3654,My Soul to Take,21500813,14744435,0.6857617430559486,6756378,0.3142382569440514,2010
3655,Winged Migration,21493351,924651,0.04302032754222457,20568700,0.9569796724577754,2001
3656,Over Her Dead Body,21458111,7563670,0.35248536089686555,13894441,0.6475146391031344,2008
3657,K-20: The Fiend with Twenty Faces,21443265,0,0.0,21443265,1.0,2008
3658,K-On! The Movie,21434003,0,0.0,21434003,1.0,2011
3659,The Merchant of Venice,21417725,3765585,0.17581629234664278,17652140,0.8241837076533572,2004
3660,Our Family Wedding,21409028,20255281,0.9461093235993713,1153747,0.053890676400628744,2010
3661,Crazy Romance,21386368,0,0.0,21386368,1.0,2019
3662,Year One in the North,21360942,0,0.0,21360942,1.0,2005
3663,Shaft,21360215,21360215,1.0,0,0.0,2019
3664,Unplanned,21354152,19005109,0.8899959595679566,2349043,0.11000404043204338,2019
3665,Waist Deep,21353303,21344312,0.9995789410191014,8991,0.000421058980898646,2006
3666,Rurouni Kenshin: Final Chapter Part II - The Beginning,21318560,0,0.0,21318560,1.0,2021
3667,Hotel Mumbai,21314816,9651611,0.4528123067072219,11663205,0.5471876932927782,2019
3668,Integrity,21290004,0,0.0,21290004,1.0,2019
3669,New York Minute,21289826,14071441,0.6609467357788645,7218385,0.33905326422113546,2004
3670,Arn: The Knight Templar,21287566,0,0.0,21287566,1.0,2007
3671,Stigmatized Properties,21276720,0,0.0,21276720,1.0,2020
3672,Michael Jordan to the Max,21268532,18650521,0.8769068311813905,2618011,0.12309316881860957,2000
3673,Astral City: A Spiritual Journey,21218935,0,0.0,21218935,1.0,2010
3674,The Prison,21205329,207481,0.009784380143312088,20997848,0.9902156198566879,2017
3675,Red Dog,21185162,0,0.0,21185162,1.0,2011
3676,ATL,21170563,21170563,1.0,0,0.0,2006
3677,Three Kingdoms,21159916,0,0.0,21159916,1.0,2008
3678,Penelope,21156270,10011996,0.47324013164891543,11144274,0.5267598683510846,2007
3679,Mindhunters,21148829,4480744,0.2118672386069224,16668085,0.7881327613930776,2004
3680,The Jacket,21126225,6303762,0.2983856320757731,14822463,0.7016143679242269,2005
3681,Wish Dragon,21120000,0,0.0,21120000,1.0,2021
3682,Beasts of the Southern Wild,21107746,12795746,0.6062109142302546,8312000,0.39378908576974536,2012
3683,The Secret Mission,21083522,0,0.0,21083522,1.0,2019
3684,My Girlfriend Is an Agent,21056256,0,0.0,21056256,1.0,2009
3685,Black Lightning,20984902,0,0.0,20984902,1.0,2009
3686,71: Into the Fire,20967660,176638,0.008424306765752593,20791022,0.9915756932342474,2010
3687,Once,20936722,9439923,0.45087874787657783,11496799,0.5491212521234222,2007
3688,The Spy Next Door 2010 Re-release,20929457,0,0.0,20929457,1.0,2010
3689,Love's a Bitch,20908467,5408467,0.2586735316367288,15500000,0.7413264683632712,2001
3690,The Devil's Rejects,20901859,17044981,0.8154767956285611,3856878,0.18452320437143893,2005
3691,Pokémon Heroes,20867919,746381,0.035766910921975495,20121538,0.9642330890780245,2002
3692,A Moment to Remember,20865847,0,0.0,20865847,1.0,2005
3693,G.O.R.A.,20839049,0,0.0,20839049,1.0,2004
3694,Pokémon the Movie: Secrets of the Jungle,20810273,0,0.0,20810273,1.0,2020
3695,Vicky and the Treasure of the Gods,20796153,0,0.0,20796153,1.0,2011
3696,Love Aaj Kal,20794985,2430083,0.11685908886205015,18364902,0.8831409111379499,2009
3697,Le Grand Chef,20794760,0,0.0,20794760,1.0,2007
3698,Best in Show,20789556,18715392,0.900230481112728,2074164,0.09976951888727205,2000
3699,I Love You Phillip Morris,20768906,2037459,0.09810141179318738,18731447,0.9018985882068127,2009
3700,Pandemic,20712567,0,0.0,20712567,1.0,2009
3701,Bobby,20704591,11242801,0.5430100502830507,9461790,0.45698994971694923,2006
3702,The Photograph,20690779,20578185,0.9945582522533347,112594,0.005441747746665314,2020
3703,Pandorum,20648328,10330853,0.5003239487478115,10317475,0.49967605125218856,2009
3704,Super Size Me,20645757,11536423,0.5587793656585225,9109334,0.4412206343414775,2004
3705,The Front Line,20629645,11018,0.0005340857780150847,20618627,0.9994659142219849,2011
3706,After We Fell,20610184,2007723,0.09741412303742654,18602461,0.9025858769625734,2021
3707,Polisse,20590872,211440,0.010268627768653994,20379432,0.989731372231346,2011
3708,Hollywoo,20587850,0,0.0,20587850,1.0,2011
3709,Walk Hard: The Dewey Cox Story,20576198,18317151,0.8902106696290539,2259047,0.10978933037094608,2007
3710,The 11 Commandments,20537839,0,0.0,20537839,1.0,2004
3711,Country Strong,20529194,20218921,0.9848862551544888,310273,0.015113744845511227,2010
3712,One Hundred Thousand Bad Jokes 2,20460352,0,0.0,20460352,1.0,2017
3713,My Life in Ruins,20455482,8665206,0.4236128975107993,11790276,0.5763871024892007,2009
3714,Yarn,20444185,0,0.0,20444185,1.0,2020
3715,Detective Conan: Jolly Roger in the Deep Azure,20440213,0,0.0,20440213,1.0,2007
3716,Doraemon: Nobita and the Wind Wizard,20428491,0,0.0,20428491,1.0,2003
3717,Beerfest,20387597,19185184,0.9410223284284067,1202413,0.05897767157159326,2006
3718,Ladies in Lavender,20377075,6765081,0.3319947048337409,13611994,0.6680052951662592,2004
3719,The Namesake,20354321,13569248,0.6666519605345715,6785073,0.3333480394654285,2007
3720,Violet Evergarden: The Movie,20339624,0,0.0,20339624,1.0,2020
3721,Brahms: The Boy II,20311536,12611536,0.6209050856616654,7700000,0.37909491433833464,2020
3722,Scabbard Samurai,20251745,0,0.0,20251745,1.0,2011
3723,Ong-Bak: The Thai Warrior,20235426,4563167,0.22550387622182996,15672259,0.77449612377817,2003
3724,Beck,20219060,0,0.0,20219060,1.0,2010
3725,How Not to Rescue a Princess,20157447,0,0.0,20157447,1.0,2010
3726,Serving Sara,20146150,16930185,0.8403682589477394,3215965,0.1596317410522606,2002
3727,Melinda and Melinda,20129327,3826280,0.19008484486341745,16303047,0.8099151551365825,2004
3728,Cado dalle nubi,20123466,0,0.0,20123466,1.0,2009
3729,Mulholland Drive,20117339,7220243,0.35890646372266233,12897096,0.6410935362773377,2001
3730,This Is Tomas,20084169,0,0.0,20084169,1.0,2019
3731,I Heart Huckabees,20072172,12785432,0.6369730191630483,7286740,0.3630269808369518,2004
3732,Evening,20016753,12492481,0.6241012715698695,7524272,0.3758987284301305,2007
3733,Asterix & Obelix: Mission Cleopatra 2002 Re-release,20015611,3115188,0.155637916824023,16900423,0.8443620831759769,2002
3734,The Divine Weapon,19991573,0,0.0,19991573,1.0,2008
3735,Kaiji 2: The Ultimate Gambler,19971259,0,0.0,19971259,1.0,2011
3736,About Her Brother,19969473,0,0.0,19969473,1.0,2010
3737,Himalaya 2001 Re-release,19960881,2487878,0.12463768508013248,17473003,0.8753623149198675,2001
3738,Crazy/Beautiful,19937988,16937988,0.8495334634567941,3000000,0.15046653654320585,2001
3739,Ballistic: Ecks vs. Sever,19924033,14307963,0.7181258432968868,5616070,0.2818741567031133,2002
3740,Get Over It,19900366,11576464,0.5817211603042879,8323902,0.4182788396957121,2001
3741,Jaane Tu,19852786,604037,0.030425805224516097,19248749,0.9695741947754839,2008
3742,Blindness,19844979,3351751,0.1688966765850445,16493228,0.8311033234149555,2008
3743,Lorelei: The Witch of the Pacific Ocean,19806585,0,0.0,19806585,1.0,2005
3744,Trick the Movie: Psychic Battle Royale,19795115,0,0.0,19795115,1.0,2010
3745,Ice 2,19788995,0,0.0,19788995,1.0,2020
3746,The Diving Bell and the Butterfly,19780116,6003227,0.3034980684643103,13776889,0.6965019315356897,2007
3747,Two Days in Paris,19776159,4433994,0.22420905899876714,15342165,0.7757909410012328,2007
3748,Hello Ghost,19774455,0,0.0,19774455,1.0,2010
3749,Summer Catch,19772447,19753553,0.9990444278343494,18894,0.0009555721656505136,2001
3750,The Perfect Man,19770475,16535005,0.8363483932480125,3235470,0.1636516067519875,2005
3751,Thomas and the Magic Railroad,19748009,15933506,0.8068411352253283,3814503,0.1931588647746717,2000
3752,Another Year,19722766,3205706,0.1625383579564854,16517060,0.8374616420435146,2010
3753,Solomon Kane,19652185,0,0.0,19652185,1.0,2009
3754,Youth in Revolt,19651093,15281286,0.7776303333356572,4369807,0.2223696666643428,2010
3755,Amelia,19643086,14246488,0.7252673027038623,5396598,0.2747326972961377,2009
3756,Don,19640129,2223961,0.11323555970533594,17416168,0.8867644402946641,2006
3757,Shackleton's Antarctic Adventure,19613216,15553324,0.7930022287013002,4059892,0.2069977712986998,2001
3758,Drop,19611028,0,0.0,19611028,1.0,2009
3759,Marrying the Mafia III,19606487,0,0.0,19606487,1.0,2006
3760,S1m0ne,19576023,9688676,0.49492565471546496,9887347,0.5050743452845351,2002
3761,Hot Summer Days,19573451,0,0.0,19573451,1.0,2010
3762,Soul Snatcher,19561221,0,0.0,19561221,1.0,2020
3763,View from the Top,19526014,15614000,0.7996511730453537,3912014,0.20034882695464626,2003
3764,Il cosmo sul comò,19494191,0,0.0,19494191,1.0,2008
3765,High Security Vacation,19487557,0,0.0,19487557,1.0,2009
3766,The Lion King 2002 IMAX Release,19486215,15686215,0.8049903483051993,3800000,0.19500965169480067,2002
3767,2046,19470239,1444588,0.0741946721866126,18025651,0.9258053278133874,2004
3768,Vanity Fair,19463185,16136476,0.8290768443088836,3326709,0.17092315569111632,2004
3769,Buried,19439764,1044143,0.05371171172654154,18395621,0.9462882882734585,2010
3770,The Turning,19428853,15472775,0.7963812892094042,3956078,0.20361871079059582,2020
3771,Kamen Rider Decade: All Riders vs. Dai-Shocker,19418091,0,0.0,19418091,1.0,2009
3772,Get Carter,19412993,14967182,0.7709878636436948,4445811,0.2290121363563053,2000
3773,The Specials,19363826,0,0.0,19363826,1.0,2019
3774,Tuck Everlasting,19344615,19161999,0.9905598534786038,182616,0.009440146521396265,2002
3775,Rock Star,19334145,17008282,0.8797017918299465,2325863,0.12029820817005354,2001
3776,Ballad,19328678,0,0.0,19328678,1.0,2009
3777,Duplex,19322135,9692135,0.5016078709728505,9630000,0.4983921290271494,2003
3778,The White Ribbon,19319671,2222862,0.115056928246863,17096809,0.884943071753137,2009
3779,Celda 211,19300483,0,0.0,19300483,1.0,2009
3780,Deep Blue,19288261,132261,0.006857072288683775,19156000,0.9931429277113162,2003
3781,Mapado,19286223,0,0.0,19286223,1.0,2005
3782,O,19260537,16025437,0.8320347973683184,3235100,0.16796520263168155,2001
3783,The Servant,19259164,0,0.0,19259164,1.0,2010
3784,Fate/Stay Night: Heaven's Feel - III. Spring Song,19252497,200000,0.010388262883510644,19052497,0.9896117371164893,2020
3785,Half Past Dead,19233280,15567860,0.809423041727672,3665420,0.19057695827232796,2002
3786,Windstruck,19225992,0,0.0,19225992,1.0,2004
3787,Martin Lawrence Live: Runteldat,19184820,19184820,1.0,0,0.0,2002
3788,Lyubov 2 Morkov,19171562,0,0.0,19171562,1.0,2008
3789,How to Lose Friends & Alienate People,19152009,2778752,0.14508932196094937,16373257,0.8549106780390506,2008
3790,The Weather Man,19126398,12482775,0.6526464104741521,6643623,0.347353589525848,2005
3791,Norwegian Wood,19115721,13000,0.000680068515333531,19102721,0.9993199314846665,2010
3792,Bhool Bhulaiyaa,19073095,1097797,0.05755736025013245,17975298,0.9424426397498675,2007
3793,Always Miss You,19015465,91884,0.0048320669518205316,18923581,0.9951679330481795,2019
3794,A Mighty Heart,19008745,9176787,0.4827665897985375,9831958,0.5172334102014625,2007
3795,Stillwater,18956329,14465535,0.7630979078280399,4490794,0.2369020921719601,2021
3796,Akeelah and the Bee,18948425,18848430,0.9947227803893991,99995,0.005277219610600881,2006
3797,The Corsican File,18922216,0,0.0,18922216,1.0,2004
3798,The Man Who Wasn't There,18916623,7504257,0.3967017263070687,11412366,0.6032982736929313,2001
3799,The Curse of the Jade Scorpion,18914307,7517191,0.3974341222229289,11397116,0.602565877777071,2001
3800,Feardotcom,18902015,13258249,0.7014198750768106,5643766,0.2985801249231894,2002
3801,The Pioneer,18900000,0,0.0,18900000,1.0,2021
3802,An Officer and a Spy,18878658,0,0.0,18878658,1.0,2019
3803,Head Over Heels,18876082,0,0.0,18876082,1.0,2010
3804,The Wild Guys 4,18873863,0,0.0,18873863,1.0,2007
3805,Kitaro,18856642,0,0.0,18856642,1.0,2007
3806,The Counterfeiters,18814713,5488570,0.291716913247627,13326143,0.708283086752373,2007
3807,The Green Knight,18769943,17173321,0.9149373016210012,1596622,0.08506269837899881,2021
3808,Swing Girls,18758613,0,0.0,18758613,1.0,2004
3809,A Mighty Wind,18750246,17781006,0.948307878200638,969240,0.051692121799361994,2003
3810,Crayon Shin-chan: Honeymoon Hurricane - The Lost Hiroshi,18738951,0,0.0,18738951,1.0,2019
3811,Mobile Suit Gundam: Hathaway,18731309,0,0.0,18731309,1.0,2021
3812,Look at Me,18729751,1737308,0.09275659884640218,16992443,0.9072434011535978,2004
3813,Iznogoud- Caliph Instead of the Caliph,18725588,0,0.0,18725588,1.0,2005
3814,Detective Conan: Strategy Above the Depths,18723952,0,0.0,18723952,1.0,2005
3815,3000 Miles to Graceland,18720175,15749959,0.8413360986208729,2970216,0.15866390137912706,2001
3816,Sinkhole,18676238,0,0.0,18676238,1.0,2021
3817,The Ninth Gate,18661336,18661336,1.0,0,0.0,2000
3818,Greta,18653107,10532219,0.56463617562479,8120888,0.43536382437521,2019
3819,Peppa Celebrates Chinese New Year,18653040,131225,0.0070350462980833155,18521815,0.9929649537019167,2019
3820,Waiting...,18637690,16124543,0.8651578065736687,2513147,0.13484219342633127,2005
3821,Max Keeble's Big Move,18634654,17294293,0.9280715917773413,1340361,0.07192840822265871,2001
3822,"Godzilla, Mothra and King Ghidorah: Giant Monsters All-Out Attack",18623382,0,0.0,18623382,1.0,2001
3823,An Unfinished Life,18618284,8586392,0.46118063297347917,10031892,0.5388193670265208,2005
3824,My Father and My Son,18612999,0,0.0,18612999,1.0,2005
3825,De-Lovely,18611951,13456633,0.7230103388946167,5155318,0.2769896611053833,2004
3826,Ho voglia di te,18594142,0,0.0,18594142,1.0,2007
3827,Empire,18591272,17600423,0.9467035391661205,990849,0.05329646083387947,2002
3828,Keeping Mum,18575768,1619466,0.0871816443874622,16956302,0.9128183556125378,2005
3829,See No Evil,18564467,15032800,0.8097620039401078,3531667,0.19023799605989228,2006
3830,Black Christmas,18529730,10429730,0.5628646504833044,8100000,0.4371353495166956,2019
3831,Turetskiy gambit,18520000,0,0.0,18520000,1.0,2005
3832,Saawariya,18513120,885574,0.04783494084195425,17627546,0.9521650591580457,2007
3833,My Baby's Daddy,18490423,17669317,0.955592903418164,821106,0.044407096581835906,2004
3834,Hanbando,18483140,0,0.0,18483140,1.0,2006
3835,Loser,18404706,15618626,0.848621325437092,2786080,0.151378674562908,2000
3836,Bandidas,18381890,0,0.0,18381890,1.0,2006
3837,As It Is in Heaven,18318233,0,0.0,18318233,1.0,2005
3838,The World's Fastest Indian,18297690,5128124,0.28026073236567023,13169566,0.7197392676343298,2005
3839,Quai des illusions,18291248,0,0.0,18291248,1.0,2004
3840,Friends with Money,18245244,13368437,0.7327080416134747,4876807,0.26729195838652525,2006
3841,Daddy Day Camp,18197398,13235267,0.7273164548030439,4962131,0.2726835451969562,2007
3842,Antitrust,18195610,11328094,0.6225729173135718,6867516,0.3774270826864282,2001
3843,My Boss's Daughter,18191005,15550605,0.8548513399891869,2640400,0.14514866001081303,2003
3844,Voice of a Murderer,18160598,0,0.0,18160598,1.0,2007
3845,All the Pretty Horses,18133495,15540353,0.8569971205219954,2593142,0.14300287947800466,2000
3846,Takizawa Enbujo Zero,18091395,0,0.0,18091395,1.0,2020
3847,Krrish,18041250,1430721,0.07930276449802535,16610529,0.9206972355019747,2006
3848,The Country Bears,18012097,16990825,0.9433007716980427,1021272,0.05669922830195729,2002
3849,Quills,17989227,7065332,0.3927535074186345,10923895,0.6072464925813655,2000
3850,Night Watch 2005 Re-release,17939389,1502188,0.08373685413700545,16437201,0.9162631458629945,2005
3851,"Carry On, Munna Bhai",17897527,2217562,0.12390326328324577,15679965,0.8760967367167543,2006
3852,My Tutor Friend,17896209,0,0.0,17896209,1.0,2003
3853,Flyboys,17834865,13090630,0.7339909777842445,4744235,0.2660090222157555,2006
3854,The New World,17823920,0,0.0,17823920,1.0,2003
3855,Battle of the Warriors,17812601,0,0.0,17812601,1.0,2006
3856,Jail Breakers,17797711,0,0.0,17797711,1.0,2002
3857,The Last Kiss,17720347,1048950,0.05919466475458974,16671397,0.9408053352454102,2002
3858,Joyeux Noel,17709155,1054361,0.059537623336630124,16654794,0.9404623766633698,2005
3859,The Promised Neverland,17698106,0,0.0,17698106,1.0,2020
3860,Memories of Tomorrow,17696020,140200,0.007922685440002894,17555820,0.9920773145599971,2006
3861,Grave Decisions,17685834,0,0.0,17685834,1.0,2006
3862,You Are My Sunshine,17650142,0,0.0,17650142,1.0,2005
3863,Kaiji: Final Game,17645779,0,0.0,17645779,1.0,2020
3864,Palais royal!,17612135,0,0.0,17612135,1.0,2005
3865,Hitman: Agent Jun,17601351,0,0.0,17601351,1.0,2020
3866,Orchestra Seats,17574836,2044858,0.11635146979465413,15529978,0.8836485302053458,2006
3867,Deliver Us from Eva,17573594,17573594,1.0,0,0.0,2003
3868,Roll Bounce,17500866,17380866,0.9931431964566781,120000,0.006856803543321799,2005
3869,Annapolis,17496992,17127992,0.9789106607581464,369000,0.021089339241853685,2006
3870,Rebound,17492014,16809014,0.9609536100302687,683000,0.03904638996973133,2005
3871,Bo Gia,17480489,350000,0.020022323174140037,17130489,0.97997767682586,2021
3872,"Paris, je t'aime",17471727,4899278,0.2804117761226466,12572449,0.7195882238773534,2006
3873,A Guy Thing,17432163,15545431,0.8917671891893163,1886732,0.10823281081068367,2003
3874,Frailty,17423030,13110448,0.7524780706914929,4312582,0.2475219293085072,2002
3875,Stormy Night,17379776,0,0.0,17379776,1.0,2005
3876,The Matador,17347231,12594698,0.7260350657692862,4752533,0.27396493423071383,2005
3877,Would I Lie to You? 2,17317084,0,0.0,17317084,1.0,2003
3878,The Importance of Being Earnest,17290970,8384929,0.4849310940913089,8906041,0.515068905908691,2002
3879,Gintama: The Final,17244651,0,0.0,17244651,1.0,2021
3880,Promising Young Woman,17122775,6460965,0.3773316533097001,10661810,0.6226683466902999,2020
3881,Digimon Adventure: Last Evolution Kizuna,17068434,0,0.0,17068434,1.0,2020
3882,Kinsey,17050017,10254979,0.6014644442876509,6795038,0.39853555571234917,2004
3883,Kung Pow: Enter the Fist,16994625,16037962,0.9437079076472709,956663,0.056292092352729174,2002
3884,Dead Weight,16987957,0,0.0,16987957,1.0,2002
3885,The Dry,16984586,364237,0.021445150326301742,16620349,0.9785548496736982,2021
3886,Bye Bye Morons,16955173,0,0.0,16955173,1.0,2020
3887,Jason X,16951798,13121555,0.7740509295828089,3830243,0.22594907041719114,2001
3888,Catch That Kid,16951702,16703799,0.9853759227244556,247903,0.014624077275544368,2004
3889,Sugar & Spice,16908947,13305101,0.7868675086627216,3603846,0.21313249133727843,2001
3890,Material Girls,16907725,11449638,0.677183831650917,5458087,0.32281616834908305,2006
3891,Zhara,16877870,0,0.0,16877870,1.0,2006
3892,Life or Something Like It,16872671,14448589,0.8563308678276249,2424082,0.1436691321723751,2002
3893,Aegis,16869261,0,0.0,16869261,1.0,2005
3894,The Good Girl,16856124,14018296,0.8316440956414417,2837828,0.16835590435855835,2002
3895,Femme Fatale,16838910,6630252,0.3937459134825235,10208658,0.6062540865174765,2002
3896,House of 1000 Corpses,16829545,12634962,0.7507607603176437,4194583,0.24923923968235623,2003
3897,Paparazzi,16796512,15714234,0.9355653126077604,1082278,0.06443468739223954,2004
3898,House of Sand and Fog,16763804,13040288,0.7778835877584825,3723516,0.22211641224151749,2003
3899,Baaghi 3,16726510,721439,0.043131472136147944,16005071,0.956868527863852,2020
3900,Dogville,16680836,1535286,0.0920389121984054,15145550,0.9079610878015946,2003
3901,CyberWorld,16653900,11253900,0.6757516257453209,5400000,0.32424837425467906,2000
3902,Digimon: The Movie,16643191,9631153,0.5786842799556888,7012038,0.4213157200443112,2000
3903,The Dish,16575074,2552992,0.1540259790092038,14022082,0.8459740209907962,2000
3904,They,16446271,12840842,0.7807752894257914,3605429,0.2192247105742086,2002
3905,The Powerpuff Girls Movie,16426471,11412414,0.6947575045181646,5014057,0.3052424954818354,2002
3906,The Magdalene Sisters,16373112,306989,0.018749581631152343,16066123,0.9812504183688476,2002
3907,One Missed Call,16367880,0,0.0,16367880,1.0,2004
3908,"Nin x Nin: Ninja Hattori-kun, the Movie",16351134,0,0.0,16351134,1.0,2004
3909,Italian for Beginners,16349568,4544753,0.27797388897370257,11804815,0.7220261110262974,2000
3910,The Emperor's Club,16318449,14118751,0.865201772545908,2199698,0.13479822745409198,2002
3911,Rabbit-Proof Fence,16217411,6199600,0.38228050087649623,10017811,0.6177194991235038,2002
3912,Caché (Hidden),16197824,3647381,0.22517722133540902,12550443,0.774822778664591,2005
3913,Just Visiting,16176732,4781539,0.2955812706793931,11395193,0.7044187293206069,2001
3914,Birthday Girl,16171098,5142576,0.31801031692467635,11028522,0.6819896830753236,2002
3915,Iris,16153953,5594617,0.3463311426002044,10559336,0.6536688573997956,2001
3916,To Be and to Have,16063920,777129,0.04837729520565341,15286791,0.9516227047943466,2002
3917,I Still Believe,16060123,9868521,0.614473562873709,6191602,0.385526437126291,2020
3918,Doraemon: Nobita and the Robot Kingdom,16053687,0,0.0,16053687,1.0,2002
3919,What the #$*! Do We (K)now!?,15998178,10942306,0.6839720123129022,5055872,0.3160279876870979,2004
3920,Upon the Magic Roads,15990882,0,0.0,15990882,1.0,2021
3921,Before Sunset,15936507,5820649,0.3652399487541404,10115858,0.6347600512458595,2004
3922,Freaky,15920855,9030855,0.5672342974042537,6890000,0.43276570259574626,2020
3923,The Stronghold,15918078,0,0.0,15918078,1.0,2021
3924,Drowning Mona,15906764,15506764,0.974853464853065,400000,0.025146535146934976,2000
3925,Public Enemy,15897574,0,0.0,15897574,1.0,2002
3926,Highlander: Endgame,15843608,12811858,0.8086452277789251,3031750,0.1913547722210749,2000
3927,Lucky Luke and the Daltons,15823762,0,0.0,15823762,1.0,2004
3928,Reminiscence,15800193,3900193,0.24684464297366493,11900000,0.7531553570263351,2021
3929,The Great Yokai War,15787492,0,0.0,15787492,1.0,2005
3930,Kiss Kiss Bang Bang,15785148,4243756,0.26884486607284264,11541392,0.7311551339271574,2005
3931,The Gospel,15778152,15778152,1.0,0,0.0,2005
3932,Lantana,15747450,4623189,0.2935833420649058,11124261,0.7064166579350942,2001
3933,Enigma 2001 Re-release,15705007,4301582,0.27389876362360105,11403425,0.7261012363763989,2001
3934,Facing Windows,15530077,543354,0.03498720579427906,14986723,0.965012794205721,2003
3935,Two Sons of Francisco,15508288,0,0.0,15508288,1.0,2005
3936,With a Friend Like Harry...,15472186,3830441,0.24756947725421605,11641745,0.7524305227457839,2001
3937,Bait,15471969,15325127,0.9905091588536663,146842,0.009490841146333735,2000
3938,Zelary,15461305,330033,0.02134574022050532,15131272,0.9786542597794947,2003
3939,The Greatest Game Ever Played,15431177,15337393,0.9939224337845389,93784,0.006077566215461076,2005
3940,Padre no hay más que uno 2: La llegada de la suegra,15373181,0,0.0,15373181,1.0,2020
3941,Minari,15369975,3110580,0.20238029014360792,12259395,0.7976197098563921,2021
3942,Alex & Emma,15368897,14218698,0.9251606019612207,1150199,0.07483939803877923,2003
3943,Brother,15250594,450594,0.029545996700194106,14800000,0.9704540032998059,2001
3944,Hey Arnold! the Movie,15249308,13728902,0.9002967216610748,1520406,0.09970327833892528,2002
3945,Something About Love,15204017,0,0.0,15204017,1.0,2021
3946,Transamerica,15151744,9015303,0.5950010111047283,6136441,0.40499898889527175,2005
3947,Surviving Christmas,15125687,11663156,0.7710827283415292,3462531,0.22891727165847078,2004
3948,The Dreamers,15121165,2532228,0.1674624937959476,12588937,0.8325375062040524,2003
3949,Boat Trip,15020293,8600126,0.5725671263536604,6420167,0.42743287364633964,2002
3950,Oldboy,14980005,707481,0.0472283553977452,14272524,0.9527716446022548,2003
3951,Undisputed,14946150,12764657,0.8540431482354988,2181493,0.14595685176450124,2002
3952,"Murder, Take One",14915208,0,0.0,14915208,1.0,2005
3953,The Last Trapper,14905929,0,0.0,14905929,1.0,2004
3954,Battle Royale II,14899584,0,0.0,14899584,1.0,2003
3955,Raise Your Voice,14867514,10411980,0.7003174841469798,4455534,0.2996825158530202,2004
3956,Josie and the Pussycats,14866015,14271015,0.9599758240523771,595000,0.040024175947622816,2001
3957,Supernova,14828081,14230455,0.9596963356215817,597626,0.040303664378418216,2000
3958,Soul Plane,14821824,14190750,0.9574226491962123,631074,0.04257735080378771,2004
3959,One Piece: Dead End Adventure,14817006,0,0.0,14817006,1.0,2003
3960,Possession,14815898,10113733,0.6826270672219801,4702165,0.3173729327780199,2002
3961,Out Cold,14782676,13906394,0.940722369887563,876282,0.059277630112437016,2001
3962,The Triplets of Belleville,14776760,7007149,0.47420063667542817,7769611,0.5257993633245718,2003
3963,Most Beautiful Week in My Life,14765033,0,0.0,14765033,1.0,2005
3964,Iron Monkey,14694904,14694904,1.0,0,0.0,2001
3965,The Way Back,14690514,13590514,0.9251217486331655,1100000,0.0748782513668344,2020
3966,Together with You,14687167,1151941,0.07843180376447002,13535226,0.92156819623553,2003
3967,Samurai Commando Mission 1549,14648713,0,0.0,14648713,1.0,2005
3968,Half a Confession,14638660,0,0.0,14638660,1.0,2004
3969,Welcome to Mooseport,14615099,14470947,0.9901367756728846,144152,0.009863224327115403,2004
3970,The Night House,14611542,7107044,0.4863993136384921,7504498,0.5136006863615079,2021
3971,Together,14572229,1034829,0.07101377558642538,13537400,0.9289862244135746,2001
3972,Hollywood Ending,14569744,4850753,0.33293330342660793,9718991,0.6670666965733921,2002
3973,Envy,14494036,13562325,0.9357176289613189,931711,0.06428237103868101,2004
3974,Malena,14493284,3448233,0.23791937010273173,11045051,0.7620806298972683,2000
3975,I Dreamed of Africa,14400327,6651522,0.4619007610035522,7748805,0.5380992389964477,2000
3976,The Tomorrow War,14400000,0,0.0,14400000,1.0,2021
3977,The Personal History of David Copperfield,14399270,1876298,0.130305077965758,12522972,0.869694922034242,2020
3978,How to Deal,14390329,14195227,0.986442144581962,195102,0.013557855418038044,2003
3979,Being Julia,14339171,7739049,0.5397138370133113,6600122,0.4602861629866887,2004
3980,Freddy Got Fingered,14333252,14254993,0.9945400387853364,78259,0.005459961214663637,2001
3981,Nightlife,14308789,0,0.0,14308789,1.0,2020
3982,Stealing Harvard,14277032,14036406,0.9831459367745341,240626,0.01685406322546591,2002
3983,Blood Rain,14270938,0,0.0,14270938,1.0,2005
3984,Pawn,14193957,0,0.0,14193957,1.0,2020
3985,Proof,14189860,7535331,0.5310363174830478,6654529,0.46896368251695225,2005
3986,What Planet Are You From?,14145677,6291602,0.4447720671128006,7854075,0.5552279328871994,2000
3987,Godzilla Against MechaGodzilla,14122958,0,0.0,14122958,1.0,2002
3988,Football Days,14117202,0,0.0,14117202,1.0,2003
3989,Crayon Shin-chan: Shrouded in Mystery! The Flowers of Tenkazu Academy,14059824,0,0.0,14059824,1.0,2021
3990,Osmosis Jones,14026418,13596911,0.9693787109438775,429507,0.030621289056122526,2001
3991,Ghosts of Mars,14010832,8709640,0.621636174068749,5301192,0.3783638259312509,2001
3992,Vizontele Tuuba,13954476,0,0.0,13954476,1.0,2004
3993,Idiots,13936317,0,0.0,13936317,1.0,2002
3994,Dirty Pretty Things,13904766,8112414,0.5834268624153761,5792352,0.4165731375846239,2002
3995,Touching the Void,13885802,4593598,0.33081258108102074,9292204,0.6691874189189793,2003
3996,French Spies,13844465,0,0.0,13844465,1.0,2004
3997,House of the Dead,13818181,10249719,0.7417560241829225,3568462,0.25824397581707753,2003
3998,Juwanna Mann,13802599,13670733,0.9904462920352899,131866,0.009553707964710124,2002
3999,The Ladies Man,13743212,13616610,0.9907880341218632,126602,0.009211965878136785,2000
4000,Dear Evan Hansen,13706130,13706130,1.0,0,0.0,2021
4001,American Outlaws,13678913,13342790,0.9754276527674385,336123,0.024572347232561534,2001
4002,Der Wixxer,13607165,0,0.0,13607165,1.0,2004
4003,Anything Else,13585075,3212310,0.23645876080919687,10372765,0.7635412391908032,2003
4004,One Night at McCool's,13473370,6290673,0.46689677489744585,7182697,0.5331032251025541,2001
4005,#Alive,13432212,0,0.0,13432212,1.0,2020
4006,One Piece: The Cursed Holy Sword,13422333,0,0.0,13422333,1.0,2004
4007,Trapped,13414416,7073251,0.5272872855590582,6341165,0.47271271444094176,2002
4008,Solarmax,13400161,13400161,1.0,0,0.0,2000
4009,Howling Village,13394556,0,0.0,13394556,1.0,2020
4010,Umizaru,13361623,0,0.0,13361623,1.0,2004
4011,RRRrrrr!!!,13315054,54361,0.004082672139369469,13260693,0.9959173278606306,2004
4012,OSS 117: From Africa with Love,13280162,0,0.0,13280162,1.0,2021
4013,Vera Drake,13267869,3775283,0.2845432827230959,9492586,0.7154567172769041,2004
4014,Vidocq,13240767,0,0.0,13240767,1.0,2001
4015,Kal Ho Naa Ho,13200241,1991922,0.15090042674220872,11208319,0.8490995732577913,2003
4016,Come Play,13180358,10475990,0.7948183198058808,2704368,0.20518168019411917,2020
4017,Head Over Heels,13127022,10424470,0.7941229930139524,2702552,0.20587700698604755,2001
4018,Toei Spring Anime Fair,13107237,0,0.0,13107237,1.0,2002
4019,The Crew,13105853,13023075,0.9936838907013531,82778,0.006316109298646948,2000
4020,Long Time Dead,13102295,0,0.0,13102295,1.0,2002
4021,The Way of the Gun,13069740,6055661,0.4633344657200526,7014079,0.5366655342799475,2000
4022,The Barbarian Invasions,13065317,5109226,0.39105258601838744,7956091,0.6089474139816126,2003
4023,Vakeel Saab,13056490,0,0.0,13056490,1.0,2021
4024,Hostage: Missing Celebrity,13043929,0,0.0,13043929,1.0,2021
4025,Onmyoji 2,13022862,0,0.0,13022862,1.0,2003
4026,Monkey King Reborn,13002635,0,0.0,13002635,1.0,2021
4027,The Divorce,12991996,9081057,0.6989731985754922,3910939,0.30102680142450783,2003
4028,Mariages!,12991310,0,0.0,12991310,1.0,2004
4029,Gods and Generals,12923936,12882934,0.9968274370903725,41002,0.0031725629096275316,2003
4030,No Escapes,12916151,0,0.0,12916151,1.0,2021
4031,Formula 51,12881605,5204007,0.4039874689528207,7677598,0.5960125310471793,2001
4032,In the Mood for Love,12854953,2738980,0.21306806800460493,10115973,0.7869319319953951,2000
4033,The Girl from Paris,12812396,183266,0.014303803909901006,12629130,0.985696196090099,2001
4034,Knockaround Guys,12806614,11715637,0.9148114404010302,1090977,0.08518855959896972,2002
4035,Samjin Company English Class,12761386,0,0.0,12761386,1.0,2020
4036,"Remember Me, My Love",12671306,227986,0.01799230481846149,12443320,0.9820076951815385,2003
4037,News of the World,12668325,12668325,1.0,0,0.0,2020
4038,Chasing Papi,12661189,6130049,0.4841606108241493,6531140,0.5158393891758507,2003
4039,Collectors,12640113,0,0.0,12640113,1.0,2020
4040,Winged Migration 2003 Re-release,12634963,10764402,0.8519535830852849,1870561,0.14804641691471515,2003
4041,Narc,12633747,10465659,0.8283891548564333,2168088,0.17161084514356667,2002
4042,The Other Side of the Bed,12630208,0,0.0,12630208,1.0,2002
4043,Maria Full of Grace,12594630,6529624,0.5184450833410748,6065006,0.48155491665892525,2004
4044,Gossip,12591270,5108820,0.4057430267161295,7482450,0.5942569732838705,2000
4045,Character,12571501,0,0.0,12571501,1.0,2021
4046,Breakin' All the Rules,12544254,12264319,0.9776842050551591,279935,0.022315794944840883,2004
4047,Apocalypse Now Redux,12543269,4626290,0.36882649969477654,7916979,0.6311735003052235,2001
4048,The Clearing,12520799,5763875,0.46034402437096866,6756924,0.5396559756290313,2004
4049,Sorority Boys,12517488,10200032,0.8148625347194262,2317456,0.18513746528057387,2002
4050,Seducing Doctor Lewis,12504038,9354342,0.7481056919372766,3149696,0.2518943080627234,2003
4051,Ready to Rumble,12452362,12394327,0.9953394384133709,58035,0.004660561586629107,2000
4052,Nine Queens,12413888,1222889,0.09850974972546876,11190999,0.9014902502745312,2002
4053,Monsieur Ibrahim,12364836,2823890,0.22838070800130306,9540946,0.7716192919986969,2003
4054,Casshern,12353768,0,0.0,12353768,1.0,2004
4055,Say It Isn't So,12320393,5520393,0.4480695542747703,6800000,0.5519304457252298,2001
4056,Chasing Liberty,12313323,12195626,0.990441491707803,117697,0.009558508292196996,2004
4057,Abandon,12302219,10727683,0.8720120329511286,1574536,0.12798796704887141,2002
4058,Koi... Mil Gaya,12168232,671372,0.05517416170237385,11496860,0.9448258382976261,2003
4059,The Eye,12165016,512049,0.04209192984209803,11652967,0.957908070157902,2002
4060,Ducobu 3,12157793,0,0.0,12157793,1.0,2020
4061,Dark Blue,12150301,9250301,0.7613227853367583,2900000,0.23867721466324168,2003
4062,On Your Mark,12100000,0,0.0,12100000,1.0,2021
4063,Don't Move,12071007,337265,0.027940088179884248,11733742,0.9720599118201158,2004
4064,Kureyon Shin-chan 2004 Re-release,12066375,0,0.0,12066375,1.0,2004
4065,Another Round,12064587,0,0.0,12064587,1.0,2020
4066,2009: Lost Memories,12049825,0,0.0,12049825,1.0,2002
4067,The Cookout,12009070,11814019,0.9837580262251782,195051,0.016241973774821863,2004
4068,Stand by Me,11900000,0,0.0,11900000,1.0,2021
4069,Layer Cake,11850214,2339957,0.1974611597731484,9510257,0.8025388402268516,2004
4070,The Rules of Attraction,11819244,6532619,0.5527103933212649,5286625,0.44728960667873513,2002
4071,Legend No. 17,11811335,0,0.0,11811335,1.0,2020
4072,Shinchan: Crash! Scribble Kingdom and Almost Four Heroes,11810389,0,0.0,11810389,1.0,2020
4073,The Son's Room,11767402,1016340,0.08636910679179652,10751062,0.9136308932082035,2001
4074,Beyond Borders,11705002,4430101,0.3784793031218619,7274901,0.621520696878138,2003
4075,Mohou-han,11702775,0,0.0,11702775,1.0,2002
4076,Wotakoi: Love Is Hard for Otaku,11702371,0,0.0,11702371,1.0,2020
4077,Les rois mages,11702020,0,0.0,11702020,1.0,2001
4078,Let Him Go,11630934,9358025,0.8045806983342868,2272909,0.19541930166571317,2020
4079,The Order,11560806,7660806,0.6626532786727846,3900000,0.33734672132721544,2002
4080,The Legend of Drunken Master,11555430,11555430,1.0,0,0.0,2000
4081,The Hunt,11473631,5812500,0.5065963860960842,5661131,0.49340361390391585,2020
4082,The Experiment,11455141,0,0.0,11455141,1.0,2001
4083,Suspect Zero,11416075,8725813,0.7643444003302361,2690262,0.2356555996697639,2004
4084,Connie and Carla,11341016,8085771,0.7129670745548723,3255245,0.28703292544512765,2004
4085,Kabhi Khushi Kabhie Gham...,11329690,2902000,0.2561411653805179,8427690,0.7438588346194821,2001
4086,The Fable: The Killer Who Doesn't Kill,11325545,0,0.0,11325545,1.0,2021
4087,The Dope,11289473,0,0.0,11289473,1.0,2003
4088,The Little Polar Bear,11243547,0,0.0,11243547,1.0,2001
4089,You Can Count on Me,11242521,9416804,0.8376060849697323,1825717,0.16239391503026768,2000
4090,Shadow of the Vampire,11155214,8293784,0.7434894570377583,2861430,0.2565105429622417,2000
4091,Naruto the Movie: Ninja Clash in the Land of Snow,11141307,0,0.0,11141307,1.0,2004
4092,Kamen Rider 555: Paradise Lost,11067556,0,0.0,11067556,1.0,2003
4093,Head-On,11030861,435395,0.039470626998200774,10595466,0.9605293730017992,2004
4094,Adrenaline Rush: The Science of Risk,11011932,10994028,0.9983741272648614,17904,0.0016258727351385752,2002
4095,The Voice of Sin,10983063,0,0.0,10983063,1.0,2020
4096,Cry Macho,10982054,9882054,0.8998365879461164,1100000,0.10016341205388354,2021
4097,District B13,10976892,1200216,0.10934023947762263,9776676,0.8906597605223774,2004
4098,30 jours max,10965768,0,0.0,10965768,1.0,2020
4099,Extreme Ops,10959475,4842259,0.441833117006061,6117216,0.558166882993939,2002
4100,The Perfect Score,10898337,10391003,0.9534484940225284,507334,0.04655150597747161,2004
4101,Lucky Numbers,10890222,10042516,0.9221589789445982,847706,0.0778410210554018,2000
4102,Here on Earth,10873148,10522168,0.9677204798463149,350980,0.03227952015368502,2000
4103,Me contro Te - Il film: La vendetta del Signor S,10779891,0,0.0,10779891,1.0,2020
4104,Godzilla: Tokyo S.O.S.,10724345,0,0.0,10724345,1.0,2003
4105,Impractical Jokers: The Movie,10691091,10691091,1.0,0,0.0,2020
4106,The Lion King 2020 Re-release,10684240,0,0.0,10684240,1.0,2020
4107,One Second,10600000,0,0.0,10600000,1.0,2020
4108,Honest Candidate,10597464,0,0.0,10597464,1.0,2020
4109,Bigfoot Family,10577144,0,0.0,10577144,1.0,2020
4110,Champion,10569737,0,0.0,10569737,1.0,2002
4111,Pollock,10558970,8598593,0.814340129766445,1960377,0.18565987023355499,2000
4112,Inuyasha the Movie: Affections Touching Across Time,10539779,0,0.0,10539779,1.0,2001
4113,Anatomy,10501958,9660,0.0009198284738902974,10492298,0.9990801715261097,2000
4114,The Cooler,10464788,8291572,0.7923306234201782,2173216,0.2076693765798218,2003
4115,Krack,10442916,0,0.0,10442916,1.0,2021
4116,The Virgin Suicides,10409377,4906229,0.4713278229811448,5503148,0.5286721770188552,2000
4117,A Touch of Spice,10395779,0,0.0,10395779,1.0,2003
4118,Town & Country,10372291,6719973,0.6478774072189066,3652318,0.35212259278109337,2001
4119,Wasabi,10366360,97220,0.009378412480369195,10269140,0.9906215875196308,2001
4120,Kaiserschmarrndrama,10357720,0,0.0,10357720,1.0,2021
4121,"Caution, Hazardous Wife: The Movie",10356359,0,0.0,10356359,1.0,2021
4122,Realm of Terracotta,10341512,0,0.0,10341512,1.0,2021
4123,Street Dancer 3D,10339127,0,0.0,10339127,1.0,2020
4124,Bibi Blocksberg,10325928,0,0.0,10325928,1.0,2002
4125,Detective Conan: The Scarlet Alibi,10308627,0,0.0,10308627,1.0,2021
4126,The Many Saints of Newark,10307052,7407052,0.7186392384553799,2900000,0.28136076154462014,2021
4127,The Wash,10229331,10097538,0.9871161662478221,131793,0.012883833752177928,2001
4128,Never Stop,10224935,0,0.0,10224935,1.0,2021
4129,My Spy,10200000,0,0.0,10200000,1.0,2020
4130,Woman on Top,10194274,5020111,0.492444189748088,5174163,0.507555810251912,2000
4131,Thirteen,10128960,4601043,0.4542463392095536,5527917,0.5457536607904464,2003
4132,Kamen Rider Ryuki: Episode Final,10112538,0,0.0,10112538,1.0,2002
4133,Pulse: A Stomp Odyssey,10086514,10086514,1.0,0,0.0,2002
4134,The Asadas,10066797,0,0.0,10066797,1.0,2020
4135,Sexy Beast,10045677,6946056,0.6914472762761534,3099621,0.30855272372384657,2001
4136,Girls on Top,10038662,0,0.0,10038662,1.0,2001
4137,Godzilla 2000: Millennium,10037390,10037390,1.0,0,0.0,2000
4138,The Deep End,10031529,8823109,0.8795378052538152,1208420,0.12046219474618475,2001
4139,Kisarazu Cat's Eye: Nihon Series,10029866,0,0.0,10029866,1.0,2003
4140,Elephant,10012022,1266955,0.12654336956111362,8745067,0.8734566304388863,2003
4141,Whatever It Takes,9902115,8745680,0.8832133337170898,1156435,0.11678666628291026,2000
4142,Shin Chan: The Adult Empire Strikes Back,9851449,0,0.0,9851449,1.0,2003
4143,3 Strikes,9832166,9832166,1.0,0,0.0,2000
4144,My Life Without Me,9726954,400948,0.041220303910144945,9326006,0.958779696089855,2003
4145,Bread and Tulips,9719848,5318679,0.547197754532787,4401169,0.4528022454672131,2000
4146,Stolen Identity 2,9687188,0,0.0,9687188,1.0,2020
4147,The Young Black Stallion,9638389,6751389,0.7004686156576582,2887000,0.29953138434234183,2003
4148,The Soul,9600000,0,0.0,9600000,1.0,2021
4149,Married for 7 Years,9545175,0,0.0,9545175,1.0,2003
4150,¡A todo tren! Destino Asturias,9500086,0,0.0,9500086,1.0,2021
4151,10 Days with Dad,9472077,2359,0.000249047806515931,9469718,0.9997509521934841,2020
4152,365 Days,9458590,0,0.0,9458590,1.0,2020
4153,Secret Zoo,9457317,0,0.0,9457317,1.0,2020
4154,Veronica Guerin,9439660,1571504,0.1664788774171951,7868156,0.8335211225828049,2003
4155,Okay Madam,9433525,0,0.0,9433525,1.0,2020
4156,Ghost Dog: The Way of the Samurai,9380473,3308029,0.3526505539752633,6072444,0.6473494460247367,2000
4157,The Flying Classroom,9378807,0,0.0,9378807,1.0,2003
4158,L'appel de la forêt,9317347,0,0.0,9317347,1.0,2020
4159,Mad Love,9306362,280046,0.030091887678557958,9026316,0.969908112321442,2001
4160,On The Line,9285342,0,0.0,9285342,1.0,2021
4161,State and Main,9206279,6944471,0.7543189816428548,2261808,0.24568101835714515,2000
4162,Inception 10th Anniversary re-release,9100000,0,0.0,9100000,1.0,2020
4163,Malasaña 32,8968845,0,0.0,8968845,1.0,2020
4164,Break the Silence: The Movie,8954345,0,0.0,8954345,1.0,2020
4165,The Closet,8948595,0,0.0,8948595,1.0,2020
4166,"Spring, Summer, Fall, Winter... and Spring",8944914,2380788,0.26616108327033666,6564126,0.7338389167296634,2003
4167,I Hate Summer,8926071,0,0.0,8926071,1.0,2020
4168,Kandahar,8914751,1418314,0.15909743300738294,7496437,0.8409025669926171,2001
4169,All About My Mother,8900000,0,0.0,8900000,1.0,2021
4170,Downhill,8899195,8287061,0.9312146772826081,612134,0.06878532271739185,2020
4171,Les blagues de Toto,8859185,0,0.0,8859185,1.0,2020
4172,Après Vous,8852763,830292,0.09378902383357603,8022471,0.906210976166424,2003
4173,The Eleventh Chapter,8845525,0,0.0,8845525,1.0,2021
4174,The Secret Garden,8834976,0,0.0,8834976,1.0,2020
4175,Kaguya-sama: Love Is War,8794981,0,0.0,8794981,1.0,2021
4176,18 Years Later,8785730,25611,0.0029150679567890203,8760119,0.997084932043211,2003
4177,Son of the Bride,8772695,624757,0.07121608582083384,8147938,0.9287839141791662,2001
4178,Ghost World,8764007,6217849,0.7094755857680168,2546158,0.29052441423198316,2001
4179,Le coeur des hommes,8755325,0,0.0,8755325,1.0,2003
4180,The Forsaken,8704851,7288451,0.8372861293088187,1416400,0.16271387069118126,2001
4181,Tini: The New Life of Violetta,8678476,0,0.0,8678476,1.0,2001
4182,Eltilerin Savasi,8613864,0,0.0,8613864,1.0,2020
4183,The Prince and the Pirate,8579972,0,0.0,8579972,1.0,2001
4184,Before Night Falls,8527517,4242892,0.49755303917893096,4284625,0.502446960821069,2000
4185,100% Wolf,8508727,658764,0.07742215727452532,7849963,0.9225778427254747,2020
4186,Agent Backkom: Kings Bear,8500000,0,0.0,8500000,1.0,2021
4187,Honey Lemon Soda,8441488,0,0.0,8441488,1.0,2021
4188,Malang,8399765,0,0.0,8399765,1.0,2020
4189,Bones,8378853,7316658,0.8732290684655764,1062195,0.12677093153442362,2001
4190,The Lord of the Rings: The Fellowship of the Ring 2021 Re-release,8377569,0,0.0,8377569,1.0,2021
4191,Merry Christmas,8228560,0,0.0,8228560,1.0,2001
4192,The Protege,8225787,7446823,0.9053021917538103,778964,0.0946978082461897,2021
4193,White Snake 2: Green Snake,8170000,0,0.0,8170000,1.0,2021
4194,New Happy Dad and Son 4,8070000,0,0.0,8070000,1.0,2021
4195,Your Eyes Tell,8020474,0,0.0,8020474,1.0,2020
4196,AI Amok,7932191,0,0.0,7932191,1.0,2020
4197,Sunny Sisters,7880000,0,0.0,7880000,1.0,2021
4198,The Lost Prince,7837980,0,0.0,7837980,1.0,2020
4199,Antoinette dans les Cévennes,7804066,0,0.0,7804066,1.0,2020
4200,The Marriage Escape,7760946,0,0.0,7760946,1.0,2020
4201,Butterfly,7733894,2092682,0.27058581356299943,5641212,0.7294141864370005,2000
4202,Spirited Away Studio Ghibli Fest 2020,7732435,0,0.0,7732435,1.0,2020
4203,Neposredstvenno Kakha,7692780,0,0.0,7692780,1.0,2020
4204,Princess Mononoke Studio Ghibli Fest 2020,7673207,0,0.0,7673207,1.0,2020
4205,The Hole,7644361,0,0.0,7644361,1.0,2001
4206,Sex and Lucía,7640680,1594779,0.2087221294439762,6045901,0.7912778705560238,2001
4207,Hard Hit,7633895,0,0.0,7633895,1.0,2021
4208,The Heist of the Century,7627100,0,0.0,7627100,1.0,2020
4209,Ants in the Pants,7625967,0,0.0,7625967,1.0,2000
4210,Monkeybone,7622365,5411999,0.7100157234664044,2210366,0.28998427653359554,2001
4211,The Medium,7592993,0,0.0,7592993,1.0,2021
4212,The Mauritanian,7527030,836536,0.11113759344655195,6690494,0.8888624065534481,2021
4213,Fukushima 50,7494243,0,0.0,7494243,1.0,2020
4214,De Gaulle,7466866,0,0.0,7466866,1.0,2020
4215,Bohemian Rhapsody 2020 Re-release,7445468,240000,0.032234373984281445,7205468,0.9677656260157186,2020
4216,Love Letter 2021 Re-release,7400000,0,0.0,7400000,1.0,2021
4217,"Turu, the Wacky Hen",7398775,0,0.0,7398775,1.0,2020
4218,Requiem for a Dream,7390108,3635482,0.49193895407211913,3754626,0.5080610459278809,2000
4219,Signal: The Movie,7344186,0,0.0,7344186,1.0,2021
4220,Mean Machine,7310206,92770,0.012690476848395244,7217436,0.9873095231516048,2001
4221,Where the Money Is,7243669,5661798,0.7816201982724501,1581871,0.21837980172754995,2000
4222,Mamma Mia! Here We Go Again 2020 Re-release,7209678,0,0.0,7209678,1.0,2020
4223,Screwed,7201701,7027345,0.9757896085938585,174356,0.02421039140614141,2000
4224,Dad,7200771,0,0.0,7200771,1.0,2021
4225,Widow of St Pierre,7193889,3193889,0.44397251611749916,4000000,0.5560274838825008,2000
4226,Couple from the Future,7160729,0,0.0,7160729,1.0,2021
4227,The (UN)perfect Guy,7154649,0,0.0,7154649,1.0,2020
4228,Back to the Wharf,7090000,0,0.0,7090000,1.0,2020
4229,Adu,7085946,0,0.0,7085946,1.0,2020
4230,Croupier,7075068,6201143,0.8764782190079304,873925,0.12352178099206962,2000
4231,Antebellum,7060384,0,0.0,7060384,1.0,2020
4232,The Best Years,7049012,0,0.0,7049012,1.0,2020
4233,Fatale,7031289,6306897,0.896975931440167,724392,0.10302406855983305,2020
4234,Spycies,7030092,0,0.0,7030092,1.0,2020
4235,Black Box,6946199,0,0.0,6946199,1.0,2021
4236,Extinct,6919950,0,0.0,6919950,1.0,2021
4237,Jim Button and the Wild 13,6901055,0,0.0,6901055,1.0,2020
4238,Are You Lonesome Tonight?,6900000,0,0.0,6900000,1.0,2021
4239,The Slurb,6854681,0,0.0,6854681,1.0,2001
4240,Judas and the Black Messiah,6795355,5446607,0.8015191259323464,1348748,0.19848087406765358,2021
4241,China: The Panda Adventure,6784985,3921642,0.5779883080065763,2863343,0.4220116919934237,2001
4242,Face Off: 48H,6781370,0,0.0,6781370,1.0,2021
4243,The Road Home,6780490,1280490,0.1888491834660917,5500000,0.8111508165339083,2001
4244,Seobok,6778823,0,0.0,6778823,1.0,2021
4245,The Piano Teacher,6749315,1012069,0.14995136543486265,5737246,0.8500486345651374,2001
4246,Silver Skates,6727993,0,0.0,6727993,1.0,2021
4247,Psy 3: W imie zasad,6725146,0,0.0,6725146,1.0,2020
4248,Blood Moon Party,6709383,0,0.0,6709383,1.0,2020
4249,Innocence,6659968,0,0.0,6659968,1.0,2020
4250,Dragon Rider,6647932,0,0.0,6647932,1.0,2020
4251,Duets,6620242,4739023,0.7158383334023137,1881219,0.2841616665976863,2000
4252,Dream Horse,6593760,2913328,0.4418310645216083,3680432,0.5581689354783916,2021
4253,Shubh Mangal Zyada Saavdhan,6574905,0,0.0,6574905,1.0,2020
4254,Chhapaak,6532100,604334,0.09251756709174691,5927766,0.907482432908253,2020
4255,Under the Sand,6531687,1452698,0.22240777918476498,5078989,0.777592220815235,2001
4256,"Love Me, Love Me Not",6494241,0,0.0,6494241,1.0,2020
4257,Ainbo,6481477,0,0.0,6481477,1.0,2021
4258,The Devil's Backbone,6459020,755249,0.11692934841508464,5703771,0.8830706515849154,2001
4259,Hammamet,6434874,0,0.0,6434874,1.0,2020
4260,Island Keeper,6410000,0,0.0,6410000,1.0,2021
4261,Lindenberg! Mach dein Ding,6404964,0,0.0,6404964,1.0,2020
4262,Midnight Swan,6397065,0,0.0,6397065,1.0,2020
4263,Nausicaä of the Valley of the Wind 2020 Re-release,6395525,0,0.0,6395525,1.0,2020
4264,Copshop,6325223,5151935,0.8145064608789288,1173288,0.1854935391210713,2021
4265,Simply Black,6323750,0,0.0,6323750,1.0,2020
4266,My Boyfriend's Meds,6292780,2971116,0.47214680951820975,3321664,0.5278531904817902,2020
4267,Bill & Ted Face the Music,6274027,3439660,0.5482379977006793,2834367,0.4517620022993207,2020
4268,August Never Ends,6200000,0,0.0,6200000,1.0,2021
4269,Hotel Belgrade,6199413,0,0.0,6199413,1.0,2020
4270,The Hobbit: The Battle of the Five Armies 2020 Re-release,6163077,0,0.0,6163077,1.0,2021
4271,Penguin Bloom,6155199,0,0.0,6155199,1.0,2021
4272,Megiddo: The Omega Code 2,6047691,6047691,1.0,0,0.0,2001
4273,Chaos,6042938,0,0.0,6042938,1.0,2001
4274,How to Be a Good Wife,6040586,0,0.0,6040586,1.0,2020
4275,Two by Two: Overboard!,6025669,0,0.0,6025669,1.0,2020
4276,The Legacy Of Dr. Death: Black File,6024046,0,0.0,6024046,1.0,2020
4277,Now or Never,5995963,0,0.0,5995963,1.0,2000
4278,The Rhythm Section,5989583,5437971,0.9079047740051353,551612,0.09209522599486475,2020
4279,Jak zostalem gangsterem. Historia prawdziwa,5975729,0,0.0,5975729,1.0,2020
4280,The Forgotten Battle,5955183,0,0.0,5955183,1.0,2021
4281,The Blood of Wolves,5908700,0,0.0,5908700,1.0,2021
4282,Twiceborn,5880157,11527,0.001960321807734045,5868630,0.9980396781922659,2020
4283,Me contro te - Il mistero della scuola incantata,5879431,0,0.0,5879431,1.0,2021
4284,Tom Thumb,5867304,0,0.0,5867304,1.0,2001
4285,The Royal Bride,5830719,0,0.0,5830719,1.0,2020
4286,Beasts Clawing at Straws,5796059,0,0.0,5796059,1.0,2020
4287,The Golden Bowl,5753678,3050532,0.5301881683333687,2703146,0.4698118316666313,2001
4288,Brave: Gunjyo Senki,5677186,0,0.0,5677186,1.0,2021
4289,Last Letter,5663972,0,0.0,5663972,1.0,2020
4290,Suicide Forest Village,5649792,0,0.0,5649792,1.0,2021
4291,Secret Magic Control Agency,5631112,0,0.0,5631112,1.0,2021
4292,Yowamushi Pedal: The Movie 2020 Re-release,5624218,0,0.0,5624218,1.0,2020
4293,A Fish Tale,5595327,563911,0.10078249224754872,5031416,0.8992175077524512,2001
4294,The Ice Road,5547480,0,0.0,5547480,1.0,2021
4295,Klassikokkutulek 2: Pulmad ja matused,5543147,0,0.0,5543147,1.0,2020
4296,Black & White,5541431,5277299,0.9523350556922932,264132,0.0476649443077068,2000
4297,Chernobyl: Abyss,5538706,0,0.0,5538706,1.0,2021
4298,Octonauts: The Ring of Fire,5512875,0,0.0,5512875,1.0,2021
4299,Made,5480653,5313300,0.9694647699827009,167353,0.030535230017299034,2001
4300,Hell's Garden,5450978,0,0.0,5450978,1.0,2021
4301,Hocus Pocus 2020 Re-release,5432992,4828000,0.8886447835741338,604992,0.11135521642586627,2020
4302,Mama Weed,5413086,29151,0.005385282997535971,5383935,0.9946147170024641,2020
4303,Read My Lips,5393526,1471911,0.2729032918354338,3921615,0.7270967081645662,2001
4304,Charlotte Gray,5323109,741394,0.139278380360049,4581715,0.860721619639951,2001
4305,Divorce Club,5316313,0,0.0,5316313,1.0,2020
4306,Kiba: The Fangs of Fiction,5283305,0,0.0,5283305,1.0,2021
4307,The in Crowd,5280035,5280035,1.0,0,0.0,2000
4308,Roadrunner: A Film About Anthony Bourdain,5249970,5249970,1.0,0,0.0,2021
4309,Beautiful Lure: A Modern Tale of Painted Skin,5239977,0,0.0,5239977,1.0,2021
4310,Poly,5236154,0,0.0,5236154,1.0,2021
4311,Cindy La Regia,5222322,0,0.0,5222322,1.0,2020
4312,Rebels @ School,5183317,0,0.0,5183317,1.0,2021
4313,The House of Mirth,5164404,3043284,0.5892807766394729,2121120,0.4107192233605272,2000
4314,Run,5127029,0,0.0,5127029,1.0,2020
4315,Love Aaj Kal,5120794,0,0.0,5120794,1.0,2020
4316,Masked Ward,5106794,0,0.0,5106794,1.0,2020
4317,Ayyappanum Koshiyum,5088713,0,0.0,5088713,1.0,2020
4318,Baba Parasi,5084342,0,0.0,5084342,1.0,2020
4319,Die Känguru-Chroniken,5081127,0,0.0,5081127,1.0,2020
4320,A Morning of Farewell,5075369,0,0.0,5075369,1.0,2021
4321,Forever Passion,5060000,0,0.0,5060000,1.0,2021
4322,Otto - Der Katastrofenfilm,5058355,0,0.0,5058355,1.0,2000
4323,The Real Exorcist,5035830,0,0.0,5035830,1.0,2020
4324,Love Story,5016645,971000,0.193555653230396,4045645,0.806444346769604,2021
4325,Mayday,5011408,0,0.0,5011408,1.0,2020
4326,Bheeshma,4997080,0,0.0,4997080,1.0,2020
4327,Made in Abyss: Dawn of the Deep Soul,4971635,0,0.0,4971635,1.0,2020
4328,Godai - The Wunderkind,4948225,0,0.0,4948225,1.0,2020
4329,Red,4920261,0,0.0,4920261,1.0,2021
4330,Zola,4913306,4844399,0.9859754307995472,68907,0.014024569200452811,2021
4331,Panga,4886124,582720,0.11926017432222351,4303404,0.8807398256777765,2020
4332,Military Wives,4885613,0,0.0,4885613,1.0,2020
4333,The Tales for Old and Young,4853143,0,0.0,4853143,1.0,2020
4334,Streltsov,4850073,0,0.0,4850073,1.0,2020
4335,The SpongeBob Movie: Sponge on the Run,4810790,4810790,1.0,0,0.0,2020
4336,The Empty Man,4796993,2992948,0.6239216942780613,1804045,0.37607830572193873,2020
4337,Palma,4792171,0,0.0,4792171,1.0,2021
4338,The Vets,4788826,0,0.0,4788826,1.0,2020
4339,The Broken Hearts Gallery,4781389,4067442,0.8506820925885763,713947,0.14931790741142376,2020
4340,Gladiator 20th Anniversary,4780585,0,0.0,4780585,1.0,2020
4341,Whipped,4775009,4159986,0.8711996144928732,615023,0.1288003855071268,2000
4342,Intruder,4751103,0,0.0,4751103,1.0,2020
4343,Held Up,4705631,4705631,1.0,0,0.0,2000
4344,Under the Open Sky,4702781,0,0.0,4702781,1.0,2021
4345,Family Swap,4628692,0,0.0,4628692,1.0,2021
4346,Wrong Turn,4561737,1251184,0.2742779778843015,3310553,0.7257220221156985,2021
4347,Separation,4509143,4509143,1.0,0,0.0,2021
4348,Major Grom: Plague Doctor,4493306,0,0.0,4493306,1.0,2021
4349,The Jungle Book 2000 Re-release,4466472,0,0.0,4466472,1.0,2000
4350,Prababushka lyogkogo povedeniya,4424649,0,0.0,4424649,1.0,2021
4351,The Tao of Steve,4406030,4342203,0.9855137164295296,63827,0.014486283570470469,2000
4352,V2. Escape from Hell,4392744,0,0.0,4392744,1.0,2021
4353,77 Heartwarmings,4345693,0,0.0,4345693,1.0,2021
4354,The Relatives,4300000,0,0.0,4300000,1.0,2021
4355,Voyagers,4298184,3149935,0.7328525256247755,1148249,0.2671474743752245,2021
4356,"Prvok, Sampon, Tecka a Karel",4294659,0,0.0,4294659,1.0,2021
4357,Mohabbatein,4279351,1070000,0.25003791462770875,3209351,0.7499620853722913,2000
4358,Ostwind - Der große Orkan,4217300,0,0.0,4217300,1.0,2021
4359,Girls und Panzer das Finale: Part III,4216657,0,0.0,4216657,1.0,2021
4360,Miracle,4213088,0,0.0,4213088,1.0,2021
4361,Boogie,4191023,4178620,0.9970405793525828,12403,0.0029594206474171103,2021
4362,East Is East,4177818,4177818,1.0,0,0.0,2000
4363,Kamen Rider Saber + Kikai Sentai Zenkaiger: Super Hero Senki,4111708,0,0.0,4111708,1.0,2021
4364,The Lord of the Rings: The Two Towers 2021 Re-release,4084695,0,0.0,4084695,1.0,2021
4365,Bossa Nova,4069261,1823297,0.4480658773177734,2245964,0.5519341226822265,2000
4366,Erkan & Stefan,4026949,0,0.0,4026949,1.0,2000
4367,Pettson & Findus - Katten och gubbens år,3920489,0,0.0,3920489,1.0,2000
4368,Operación Camarón,3915204,0,0.0,3915204,1.0,2021
4369,Master Ji Gong,3860000,0,0.0,3860000,1.0,2021
4370,Karnan,3817585,0,0.0,3817585,1.0,2021
4371,Operation Portugal,3795575,1096,0.0002887573029119435,3794479,0.9997112426970881,2021
4372,Up at the Villa,3740113,2933161,0.7842439519875469,806952,0.2157560480124531,2000
4373,The Big Kahuna,3728888,3165544,0.8489243978365668,563344,0.1510756021634332,2000
4374,12 Mighty Orphans,3709952,3686295,0.9936233676338669,23657,0.006376632366133039,2021
4375,"Summer of Soul (...Or, When the Revolution Could Not Be Televised)",3610758,2320649,0.6427041081124795,1290109,0.3572958918875206,2021
4376,Lie Detector,3600000,0,0.0,3600000,1.0,2021
4377,The Lord of the Rings: The Return of the King 2021 Re-release,3573925,0,0.0,3573925,1.0,2021
4378,Presidents,3569522,0,0.0,3569522,1.0,2021
4379,Mission Possible,3563279,0,0.0,3563279,1.0,2021
4380,Price of Glory,3548556,3440228,0.9694726531017124,108328,0.030527346898287643,2000
4381,Miracle: Letters to the President,3547112,0,0.0,3547112,1.0,2021
4382,Gun Shy,3221280,1638202,0.5085562260964586,1583078,0.49144377390354144,2000
4383,Beautiful,3169930,3157348,0.996030827179149,12582,0.003969172820850933,2000
4384,Isn't She Great,3003296,2962465,0.9864046034756481,40831,0.013595396524351912,2000
4385,No More School,2870533,0,0.0,2870533,1.0,2000
4386,Flickering Lights,2760019,0,0.0,2760019,1.0,2000
4387,The Color of Paradise,2724595,1817216,0.6669673841433313,907379,0.3330326158566686,2000
4388,God's Army,2637726,2637726,1.0,0,0.0,2000
4389,But I'm a Cheerleader,2595216,2205627,0.849881859544639,389589,0.15011814045536095,2000
4390,Bamboozled,2463650,2274979,0.9234180991618127,188671,0.07658190083818724,2000
4391,East/West,2321029,2321029,1.0,0,0.0,2000
4392,Shower,2150929,1157764,0.5382623043345457,993165,0.4617376956654543,2000
4393,Left Luggage,2111280,1069540,0.5065836838316092,1041740,0.4934163161683907,2000
4394,Blood Simple 2000 Re-release,2068701,1701855,0.82266842815854,366846,0.17733157184145992,2000
4395,Marlene,2061924,0,0.0,2061924,1.0,2000
4396,Hamlet,2046433,1577287,0.7707493966330684,469146,0.22925060336693162,2000
4397,The Broken Hearts Club: A Romantic Comedy,2019121,1746585,0.8650224528396268,272536,0.13497754716037325,2000
4398,Cecil B. Demented,1961544,1284646,0.6549157194536549,676898,0.3450842805463451,2000
4399,The Life and Times of Hank Greenberg,1712385,1712385,1.0,0,0.0,2000
4400,The Girl on the Bridge,1708839,1708839,1.0,0,0.0,2000
